มานี	maanee	person's name	
มี	mee	[to] have, has	[to] have, there is
ตา	dtaa	maternal grandfather, grandfather, mesh, pattern, eye, turn, time, move	
กา	gaa	crow, [to] make a mark, make a sign, kettle, teapot	
อา	aa	uncle	
นา	naa	field, farm	
งู	nguu	snake, serpent, viper	
ปู	bpuu	[to] cover, pave over, crab	
ดู	duu	[to] appear, seem, [to] watch, look, see	
มา	maa	[to] come, arrive, to, in, into, towards, More Detail, The translation of มา in this context depends on the primary verb, but it frequently has no direct equivalent in English and so may be untranslatable., It's a marker that puts the main verb in the present perfect tense	
รู	ruu	hole	
พา	phaa	[to] bring, lead, guide	
โต	dto	dog's name	[to be] big, large, grown up
หา	hǎa	[to] search for, look for, otherwise, no, not, [to] meet, visit, [to] accuse, blame	
มาหา	maa hǎa	[to] come to meet, call on, drop in on	
สีเทา	sěe tao	cat's name	[to be] gray
ชูใจ	chuujai	person's name	[to] encourage, inspire, hearten
ไป	bpai	[to] go, to, off, away, into, in	[to] go, leave, depart, to, off, away, into, in, too much, excessively, More Detail, The translation of ไป in this context depends on the primary verb, but it frequently has no direct equivalent in English and so may be untranslatable.
ไปหา	bpai hǎa	[to] visit, go to see, meet	
ดีใจ	deejai	[to be] happy, glad, pleased	
ก็	gôr	then, so, therefore [conj]	then, so, therefore, also, likewise, well, umm, err, It's a marker used when joining clauses of a sentence together
ไวไว	wai wai	swiftly, fast, quickly	
ขา	khǎa	leg, limb, foot, partner	
หู	hǔu	ear	
อะไร	arai	what, something, anything, whatever	
เอา	ao	[to] want, desire, [to] take, bring, ok, right, well	
ถู	thǔu	[to] scrub, wipe, scour	
ปู	bpuu naa	[to] cover, pave over, crab	
ปููนา	bpuu naa	field crab	
สี	sěe	colour, color, [to] rub, scrape, graze	
ดำ	dam	[to be] black, dark, [to] dive, submerge, remain under water	
จะ	jà	will, shall	
ตี	dtee	"[to] hit, beat, strike, a.m., [to] set, assess, determine, More Detail, Although the principal meaning of ตี is ""to strike"", it's also used to refer to each hour from 1am to 5am. This comes from a practice in olden times when night watchmen would strike (ตี) a bell on the hour each hour during the night to reassure local residents of their safety and alert them to the time."	
ใน	nai	inside, interior, internal	in, of
เท	tay	[to] pour, pour out	
ยา	yaa	medicine, medication, drug	
ทา	thaa	[to] apply topical medicine	[to] paint, coat
เบาเบา	bao bao	[to be] soft, gentle, light	
เกา	gao	[to] scratch, scrape	
กำ	gam	handful, fistful, [to] grasp, hold, clench	
มือ	mue	hand	
ขอ	khǒr	[to] ask for, request for, ask	
แบ	bae	[to] hold out one's hand	[to] open up, spread out
แลดู	lae duu	[to] look at, see	
ถือ	thǔe	[to] hold, bear, carry, [to] resent, [to] consider as, regard as, [to] respect, observe, More Detail, a belief or religion	
โบ	boo	ribbon, bow	
ชู	chuu	[to] raise, lift, boost	
คอ	khor	neck, throat, collar	
ดุ	dù	[to] scold, reproach, blame	fierce, ferocious, unfriendly
ใบ	bai	paper, sheet, document, sail, leaf, More Detail, ใบ is a classifier for fruit and eggs, general types of containers (bags, boxes, bowls, buckets, cans, cups etc), and also for pieces of paper, documents and tickets.	
บัว	bua	lotus	
ตัว	dtua	"self, oneself, character, letter, entity, body, physique, More Detail, ตัว is a classifier every type of animal, all pieces of clothing (except ones that come in pairs, but including trousers), chairs, tables and other pieces of furniture, letters and numbers of the alphabet, and also functions as a general purpose classifier for things and objects., It's a prefix for an actor or character, It's a prefix meaning ""someone or something that does/is..."""	
เกาะ	gò	[to] hold, cling, arrest, island, isle	
มัว	mua	[to] engrossed (in), concentrating (on), [to be] dim, hazy, obscure	
พอใจ	phorjai	[to] be satisfied, be pleased, be content	
หัวเราะ	hǔaró	[to] laugh	
หัว	hǔa	head	
ปิติ	bpìdtì	Person's name	joy, gladness, happiness
ขี่	khèe	[to] drive, ride	
ม้า	máa	bench, stool, horse, pony	
เขา	khǎo	he, she, him, her, they, them, hill, mountain, It's a marker that adds emphasis to the preceding noun or pronoun	
งอ	ngor	[to] bend, crook, flex, [to be] bent, crooked	
เข่า	khào	knee	
เวลา	weelaa	time	
แก่	kàe	to, for, [to be] old, elderly, [to] be accustomed to, be an old hand at	
ให้	hâi	[to] give, let, have	[to] give, offer, [to] let, have, to, for, so that, It's a marker that makes the following adjective into an adverb
ชื่อ	chûe	[to] be named, name, first name	
ว่า	wâa	[to] say, tell, that [conj]	that, [to] say, tell, [to] blame, criticise
เจ้าแก่	jâo gàe	horse's name	
เข้า	khâo	[to] enter, reach, get into, in, into, [to] get along with, be compatible with	
เกะกะ	gègà	[to] obstruct, block, impede, disorderly	jumblingly, disorderly, untidily, [to] be pugnacious, be disobedient, be roguish
เห่า	hào	[to] bark, hiss	
ไม่	mâi	no, not	
ขู่	khùu	[to] intimidate, threaten, menace	
ฟู่ฟู่	fûu fûu	sound of cat hiss	
ภูเขา	phuukhǎo	hill, mountain	
น่าดู	nâa duu	[to be] attractive, charming	
แยะ	yáe	many, much, abundantly	abundantly, plentifully, numerously
นก	nók	bird	
หมี	meě	bear	
และ	láe	and	
กระรอก	gràrôrk	squirrel	
ลิง	ling	monkey, ape, macaque	
เรา	rao	we, us, I	
น่าจะ	nâa jà	should, had better	
เช้า	cháo	morning	
รอ	ror	[to] wait (for)	
ที่นี่	thêe nêe	here	
เล่า	lâo	[to] tell, describe, say	
พ่อ	phôr	father, dad, daddy, I, you	
เจอ	joe	[to] meet, find	
เสือ	sǔea	tiger	
ดุ	dù	[to be] savage, ferocious, wild	fierce, ferocious, unfriendly
ที่	têe	that, which, who, to, at, place, area, land, It's a thing for an object used for	
รู้	rúu	"[to] know, More Detail, รู้ is ""to know"" in the sense of knowing information to say ""to know"" in the sense of knowing someone รู้จัก is used instead"	
แย่	yâe	terribly, badly, [to be] terrible, horrible	
ไว้	wái	[to] keep, save, store	
ดี	dee	[to be] good, nice, D, the letter D	
บ้าน	bâan	home, house	
อย่า	yàa	do not, don't, never, More Detail, A phrase using อย่า often also includes the particle นะ, which softens the meaning and makes more like a polite request rather than an order.	
อยู่	yùu	[to] be at , live at, stay (an auxiliary used to put the verb in the present continuous tense)	[to] be at, live at, stay, It's an auxiliary used to put the verb in the present continuous tense, that shows the action of the verb is currently taking place
นาน	naan	long, for a long time	
ลา	laa	donkey, [to] leave, say goodbye, bid farewell	
ถ้า	thâa	if	
ผ่าน	phàan	[to] pass, pass over, pass by	
แวะ	wáe	[to] stop, call at, call on	
ชี้	chée	[to] indicate, mark, show	
ต้นจำปี	dtôn jambpee	White Chempaka, More Detail, Scientific Name:Michelia Alba	
นอน	norn	[to] sleep, lie down	
อยู่	yùu	(an auxiliary used to put the verb in the present continuous tense)	[to] be at, live at, stay, It's an auxiliary used to put the verb in the present continuous tense, that shows the action of the verb is currently taking place
ใต้	dtâi	south, under, beneath, below, southern	
อ่าน	àan	[to] read	
นิทาน	níthaan	fable, tale, story	
ทำ	tham	[to] do, make	
แม่	mâe	mother, you, I	
ใส่	sài	[to] put on, wear (clothes)	[to] put in, add, apply, at, to, towards, [to] put on, wear
เสื้อ	sûea	shirt, blouse, T-shirt	
สีฟ้า	sěe fáa	[to be] blue	
ถือ	thǔe	[to] hold, bear, carry, [to] resent, [to] consider as, regard as, [to] respect, observe, More Detail, a belief or religion	
เสื่อ	sùea	mat	
จาน	jaan	plate, dish	
มะม่วง	mámûang	mango, mango tree	
เห็น	hěn	[to] see	
ปู	bpuu	[to] carpet, lay a carpet	[to] cover, pave over, crab
นั่ง	nâng	[to] sit	
บน	bon	on, upon, above, [to] vow, take an oath, pray	
วาง	waang	[to] put down, set down, place	
กิน	gin	[to] eat, consume, More Detail, As well as food, กิน is also used when referring to drinks and medicines in Thai.	
ว่าง	wâang	[to be] free, empty, vacant	
พูด	pôot	[to] talk, say, speak	
ย่า	yâa	grandmother, grandma, granny	
ของ	khǒrng	of, things, stuff, possessions	
คะ	khá	particle used by female at the end  make them more polite	It's a particle used by female speakers at the end of questions to make them more polite
ทำไม	thammai	why	
บ้าง	bâang	some, any	
ป้า	bpâa	aunt	
ลุง	lung	uncle	
กอด	gòrt	[to] embrace, hug	
น้า	náa	uncle, aunt	
เฝ้า	fâo	[to] watch (over), take care (of), protect, [to] have an audience (with)	
หึหึ	Heu, heu	a sound of laughing	
เดิน	dern	[to] walk	
มอม	morm	[to be] dirty, shabby, [to] intoxicate, ply someone with alcohol	
หน้า	nâa	in front of, front, face, front, top, next, following, upcoming, page, season	
พอ	phor	as soon as, when, just when, just after, [to be] enough, sufficient, appropriate	
โผ	phǒo	[to] rush, go headlong	[to] rush up (to)
จน	jon	until, till, [to be] poor, impoverished, broke	
ล้ม	lóm	[to] abolish, cancel, [to] die, pass away, [to] fall down, fall, drop	
ลง	long	[to] write down, note down, register, down, downward, [to] go down, reduce, descend, [to] apply, use, put down, [to] get out off, get off, [to] enter	
แผ่	phàe	[to] spread out, stretch out, expand	
เลีย	lia	[to] lick	
แก้ม	gâem	cheek	
ไล่	lâi	[to] remove, expel	
มัน	man	it, he, she, him, her, [to be] glossy, shiny, oil, grease, fat, [to be] fun, enjoyable, [to be] oily, greasy, It's a marker used after a noun or pronoun to emphasize it as the subject of the sentence, More Detail, using มัน to mean he/she is regarded as being insulting, unless used by close friends	
นะ	ná	It's a particle used to make a sentence seem softer, more persuasive or less abrupt	
เชื่อฟัง	chûea fang	[to] obey, pay attention to	
ล้าง	láang	[to] wash clothes, launder, clean	
ตาม	dtaam	along, around, among, through, [to] follow, pursue, come after, according to, in accordance with	
เมื่อไร	mûea rài	when, whenever, when	
โรงเรียน	roongrian	school	
ยัง	yang	not yet, still, yet, abbreviated form of อย่าง, to, [to] have, be, More Detail, a place or destination	
โต	dto	[to be] big, large, grown up	
เท่า	thâo	"as much as, equal to, It's a classifier for an amount of something when making a comparison, usually translated as "" -times (as much) -fold (as much)"""	
เรียน	rian	[to] learn, study	
หนังสือ	nǎngsǔe	book, letter	
น่ะซี	nà see	particle used to show emphasis	
น่ี่	nêe	this, these	
ใช่ไหม	châi mái	right ?, is that right?, is that true?, More Detail, question particle used when seeking confirmation of something thought to be true	
เพื่อน	phûean	friend, mate, pal	
มานะ	maaná	person's name	
พี่	pêe	call older brother or sister	brother, sister, friend, relative, colleague, he, she, him, her, you, I
ผู้หญิง	phûuyǐng	woman, lady, female, girl	
เป็น	bpen	is, [to] be, to, into, as, for, of, can, [to be] alive, living, [to] have, More Detail, เป็น is used when describing the manner or result of a verb, and before expressions of quantity or periods of time.The translation varies depending on the context, and it may not need to be translated into English at all. For instance: (translation of เป็น in italics) ตัดเป็นชิน - Cut into pieces รอเป็นชั่วโมง - Wait for hours แปลไทยเป็นอังกฤษ - Translate Thai to English คนเป็นล้าน - Millions of people เช่าเป็นเดือน - Monthly hire(เป็น not translated)	
ใช่่	châi	yes	
ปีหน้า	bpee nâa	next year ,	next year, coming year
โต๊ะ	dtó	table, desk	
ได้ไหม	dâai mái	can, be able to	
จึง	jeung	then, therefore, consequently	
เลอะเทอะ	lóe thóe	[to] be stained, be soiled, be dirty	
ฟัง	fang	[to] listen (to something), hear (something)	
ทิ้ง	thíng	[to] leave, throw away, discard	
ถัง	thǎng	bucket, tank, barrel	
ผง	phǒng	powder, dirt, dust	
ปาก	bpàak	mouth, lip	
สะอาด	sà-àat	[to be] clean, fresh, pure	
บอก	bòrk	[to] tell, say, describe	
สอน	sǒrn	[to] teach, instruct, educate	
จำไว้	jam wái	[to] remember, bear in mind, keep in mind	
เด็ก	dèk	[to be] childish, immature, child, children	
มัน	man	it, he, she, him, her, [to be] glossy, shiny, oil, grease, fat, [to be] fun, enjoyable, [to be] oily, greasy, It's a marker used after a noun or pronoun to emphasize it as the subject of the sentence, More Detail, using มัน to mean he/she is regarded as being insulting, unless used by close friends	
มาก	mâak	very much, a lot, very	
วิ่ง	wîng	[to] run	
อีก	èek	again, once more, more	
กัน	gan	one another, each other, together, jointly, [to] keep out, prevent, set aside	
สอง	sǒrng	two	
คน	khon	person, people, [to] stir, mix, More Detail, คน is the classifier for nouns referring to people.	
สาม	sǎam	three	
วันหนึ่ง	wannèung	someday, one of these days	
สิบ	sìp	ten	
ทุกวัน	thúk wan	every day, always, all the time	everyday, always, all the times
เก้า	Gâo	nine	
หนึ่ง	nèung	one	
ซน	son	[to] be mischievous, be naughty	
ไม้	máai	wood, lumber, timber, mark, stick, hand, plant, tree, strategy, trick, It's a prefix used before names of plants, More Detail, a prefix used before names of grammatical marks or symbols	
ตี	dtee	"[to] hit, beat, strike, a.m., [to] set, assess, determine, More Detail, Although the principal meaning of ตี is ""to strike"", it's also used to refer to each hour from 1am to 5am. This comes from a practice in olden times when night watchmen would strike (ตี) a bell on the hour each hour during the night to reassure local residents of their safety and alert them to the time."	
ลุก	lúk	[to] get up, rise, stand up, [to] burn, be in flames, catch fire	
ทับ	tháp	[to] overlay, put on the top, place on top of, cottage, hut, shack	
ไหม	mǎi	silk, It's a particle used to turn a statement into a question, similar to a question mark	
ซิ	sì	It's a particle used to show emphasis	
เด็็กดี	dèk dee	good boy, good girl	
นับ	náp	[to] count, [to] regard as, count as, adopt as	
กี่	gèe	how much, how many, loom	
สี่	sèe	four	
ห้า	hâa	five	
หก	hòk	[to] spill, fall, splatter, six	
เจ็ด	jèt	seven	
แปด	bpàet	eight	
วีระ	weerá	person's name	
ห่าง	hàang	[to be] far away, distant	
ร้อง	róng	[to] cry, cry out, complain, [to] sing	
ช้า	cháa	[to] be slow, be sluggish, slowly, late, evil, wicked	
ฮี้	hée	a horse sound	neigh, humph
เก่ง	gèng	excellently, expertly, proficiently, [to be] skilled, talented, proficient	
แล้ว	láew	and, and then, and after that, already, More Detail, used a general marker that indicates a specified action has happened or state has been attained	
ไหว	wǎi	can, be able to, [to] vibrate, shake	
เดี๋ยว	dǐeow	moment, in just a minute, in just a moment	
นึก	néuk	[to] consider, think, bring to mind	
ถึง	těung	[to] reach, arrive, get to, even though, even if, about, of	
สีขาว	sěe kǎao	[to be] white	
ต้นไม้	dtôn máai	tree, plant	
ๆ		It's a character used to indicate the previous word is repeated	
กับ	gàp	with, together with	
นี้ี้	nêe	this	
หาง	hǎang	tail, end, back	
ยาว	yaao	[to be] long, lengthy, extensive	
ตกใจ	dtòk jai	[to be] shocked, startled	
เจี๊ยก	jíak	sound of monkey	
หนี	něe	[to] escape, avoid, flee	
ขึ้น	kêun	[to] enter, get on, get in, [to] develop, progress, [to] go up, rise, increase, up, upward, [to] depend on, subject to	
เจ้าจ๋อ	jâo jǒr	monkey's name	
ทุกคน	túk kon	everyone, everybody	
ทั้ง	táng	all, entire, whole	
ตัวงอ	dtua ngor	[to] bend, crook, flex	
หญ้า	yâa	grass	
เล่น	lên	[to] play	
หลัง	lǎng	following, next, later, after, behind, back, behind, rear, หลัง is the classifier for a house	
สวน	sǔan	garden, park, field, [to] pass, cross	
ใหญ่	yài	[to be] big, large, great	
ชวน	chuan	[to] persuade, induce	
เที่ยว	tîeow	[to] go out, travel, tour	
เสียง	sǐang	sound, voice, opinion	
ดัง	dang	as, according to, like, as, [to be] famous, celebrated, well-known, [to be] loud, noisy, out loud, loudly	
ใคร	krai	who, someone, anyone	
เธอ	ter	you, she, her	
ไหน	nǎi	whichever one, which, somewhere, anywhere, where, which place, More Detail, a shortened form of ที่ไหน	
หรือ	rěu	(question particle used when seeking confirmation of something thought to be true, or to make a question sound softer)	or, It's a question particle used when seeking confirmation of something thought to be true, or to make a question sound softer
รัก	rák	[to] love	
คง	kong	may, will probably, might, [to] endure, remain, [to be] enduring, stable, fixed	
ฉัน	chǎn	I, me, [to] eat	
กล้วย	glûay	banana	
มะละกอ	má-lá-gor	papaya	
มะพร้าว	má-práao	coconut	
ฝึก	fèuk	[to] practise, exercise, train	
ได้	dâai	can, be able to, [to] get, receive, obtain, got to, did, get to	
ชอบ	chôp	[to] like, [to be] right, appropriate, virtuous	
นก	nók	bird	
สุก	sùk	[to be] ripe, mature, ripened, [to be] cooked, done	
น่ากิน	nâa gin	[to be] tasty-looking, appetizing	
ลูก	lôok	child, offspring, you, ลูก is the classifier for anything small and round shaped - mostly fruit and types of balls. It is also the classifier for hills, mountains, storms, hurricanes and waves too, It's a prefix used before small objects, usually round or spherical, It's a prefix used before a subordinate, purchaser, employee or junior partner	
นกแก้ว	nók gâew	parrot	
มด	mód	ant	
แดง	daeng	red	
ช่วย	chûay	[to] help, aid, assist, please	
ออก	òok	out, out of, [to] issue, produce, reveal, [to] leave, exit, go out	
แต่	dtàe	only, just, but, from, since	
เลี้ยง	líang	[to] have a party, have a feast, [to] bring up, raise, take care of, [to] provide, pay for, step-, More Detail, a relation by marriage	
อยาก	yàak	[to] want to	
เขา	kǎo	he, she, him, her, they, them, hill, mountain, It's a marker that adds emphasis to the preceding noun or pronoun	
สวย	sǔay	[to be] beautiful, attractive, pretty	
ซื้อ	séu	[to] buy, purchase, pay for	
กระโปรง	grà-bprong	skirt	
ถุงเท้า	tǔng-táo	sock	
รองเท้า	rong-táo	shoe, shoes	
กระเป๋า	grà-bpǎo	bag, pocket, wallet	
ไชโย	chai-yoh	"Hooray!, Cheers!, More Detail, ไชโย is the Thai equivalent to the English ""hip hip hooray!"", which you can often hear at birthday toasts and other celebrations. The format is usually like: ไช...โย (chai...yo) ไช...โย (chai...yo) ไช ไช ไช...โย โย โย (chai chai chai...yo yo yo!)"	
โฮ้ง	hǒhng	sound of dog	
ถาม	tǎam	[to] ask	
เหมือน	měuan	like, as, as if, as though	
ด้วย	dûay	(polite particle used in requests)ests	by, with, through, as well, also, too, It's a polite particle used in requests, and expressions of congratulation or condolence
ห่วง	hùang	[to] care about, be concerned about, ring, hoop, loop	
จริง	jing	[to be] real, true, actual, really, truly	
สวม	sǔam	[to] wear, be dressed in, have on	
ชม	chom	[to] admire, praise, commend	[to] see, watch, look, [to] praise, laud, compliment
น่ารัก	nâa rák	[to be] cute, attractive, pretty	
ชอบใจ	chôp jai	[to be] pleased, satisfied	
วันนี้	wan née	today	
ครู	kruu	teacher, instructor, school teacher	
สมุด	sà-mùd	book, workbook, notebook	
ดินสอ	din-sǒr	pencil	
จับ	jàp	[to] catch, seize, hold	
พบ	póp	[to] find, meet, discover	
ยืน	yeun	[to be] long-lasting, durable, long, [to] stand, stand up	
ไหว้	wâi	[to] wai (way to greeting or pay respect)	[to] wai, More Detail, The 'wai' is a prayer like gesture which is perfomed with a slight bow. It's widely used in Thailand as a standard greeting, and also when apologising, saying thanks and to show respect. Thai people frequently wai towards a Buddha image when passing by one, sometimes even while driving! If there's a perceived difference in status between two people perfoming the wai, then it is usually the junior or 'lower status' person who will wai first. For instance, a student will wai the teacher first, and not the other way around. The more senior will then usually 'wai' back (รับไหว้), although this is unnecessary in certain situations such as being 'wai-ed' to by children or cashiers. The higher the hands are raised and the deeper the bow, the greater the respect being shown to the recipient of the 'wai'. A กราบ is a step up from the wai and is used when worshipping and showing reverence, predominately to Buddha images or the Royal family.
ต้อง	dtông	have to, must, [to] touch, contact, [to] be in accordance (with), in agreement (with)	
รู้จัก	róo jàk	[to] know (someone)	
บันได	ban-dai	stairs, steps	
ครูใหญ่	kruu yài	headmaster, headmaster in school	
ยิ้ม	yím	[to] smile, beam	
ตอบ	dtòp	[to] answer, respond, reply, [to be] sunken, thin, lean	
ผู้ใหญ่	pôo yài	adult, senior, elder	
หน้าเหลอ	nâa lěr	silly face	
ผม	pǒm	I, me (used by men only)	I, me, hair
ครับ	kráp	It's a particle used by male speakers at the end of sentences to make them more polite	
ห้องเรียน	hông rian	classroom	
สบาย	sà-baai	easily, comfortably, [to] be fine, be well, be happy	
ห้อง	hông	room (ห้อง is also the classifier for rooms.)	
เก้าอี้	gâo-êe	chair, stool, seat	
ไพลิน	pai-lin	person's name	sapphire
เพราะ	prór	because, because of, [to be] nice, pleasant, good	
เร็ว	reo	[to be] quick, fast, speedy	
สูง	sǒong	[to be] tall, high	
ฟัน	fan	tooth, teeth, [to] cut, hack, slash	
เคย	koie	once, ever, used to, [to] be used to	
ออกกำลังกาย	òok gam-lang-gaai	[to] exercise, work out	
ขยัน	ká-yǎn	[to be] hard-working	
แปรง	bpraeng	brush, scrub, [to] brush, scrub, clean	
บ่อย	bòi	often	
ข้อ	kôr	item, provision, clause, More Detail, ข้อ is the classifier for a point, item or clause (e.g. in a contract).	
นักเรียน	nák rian	student, learner, More Detail, usually referring to junior or high school students	
นะจ๊ะ	ná já	particle used at the end of sentences	
ล่ะจ๊ะ	lâ já”	particle used at the end of sentences	
อย่าง	yàang	"way, sort, variety, as, like, More Detail, อย่าง is a classifier for referring to types, kinds or sorts of objects., More Detail, converts an adjective to an adverb, equivalent to English -ly suffix or saying ""in a ... way"""	
เปิด	bpèrt	[to] open, turn on, switch on	
ตื่น	dtèun	[to] wake up, be awake, get up	
อาบน้ำ	àap nám	[to] shower, take a shower	
เตรียม	dtriam	[to] prepare, get ready, make ready	
ข้าว	kâao	rice, More Detail, As rice is the staple of the Thai diet, ข้าว is often used to refer to food or meals in a general sense too.	
ตั้งใจ	dtâng jai	[to] intend (to), aim (to), mean (to)	
ลืม	leum	[to] forget	
ทัน	tan	[to be] on time, up-to-date, in time, on time	
ส่วน	sùan	as for, for, part, portion, component	
กำลัง	gam-lang	power, energy, strength, It's an auxiliary used to put the verb in the present continuous tense	
สนาม	sà-nǎam	field, ground	
สนุกสนาน	sà-nùk-sà-nǎan	cheerfully, joyfully, hilariously, [to be] fun, enjoyable, happy	
ระฆัง	rá-kang	bell	
เข้าแถว	kâa tǎe	[to] stand in row, line up, queue up	
เสา	sǎo	pillar, post, pole	
ธง	ton	flag	
ดูแล	duu lae	[to] look after, take care, tend	
เรียบร้อย	rîap rói	[to] be ready, be set, be normal, [to] be polite, be well-mannered	
เพลง	playng	song	
ชาติ	châat	nation, country, nature, life, incarnation, existence	
สู่	sòo	to, toward ,  up into	to, toward, into
ยอด	yôd	top, peak, tip	
พระ	prá	Buddha image, Buddha statue, monk, abbot	
เบิกบาน	bèrk baan	[to be] joyful, delighted, happy, happily, joyfully	
ใกล้	glâi	[to be] near, close, [to] be close to, be near to	
คุย	kui	[to] talk, chat, speak, [to] brag, boast, swagger	
เงียบ	ngîap	silently, quietly, softly, [to be] silent, quiet, still	
สวัสดี	sá-wàt-dee	hello, hi, good morning, good afternoon, bye, goodbye	
ทัก	ták	[to] greet, address, speak to, [to] warn, remark, protest	
กระโดด	grà-dòht	[to] plunge in/into, jump over, leap, [to] skip, pass over, leave out	
หมา	mǎa	dog	
ท่าโก้	tâa gôh	[to] be pretty, be stylish, be attractive	
ลอย	loi	[to] float, drift	
คาง	kaang	chin	
หลาย	lǎai	many, several	
เล่าขาน	lâo kǎan	[to] tell, narrate	
ท่ั่วไป	tûa bpai	[to be] general, common, ordinary	
ตน	dton	oneself, self	
สับสน	sàp sǒn	[to] be confused, be mixed up	
ทันที	tan tee	immediately, at once, right away	
หัน	hǎn	[to] turn around, face about, move around	
เรื่อง	rêuang	about, regarding, concerning, problem, trouble, matter, affair, thing, More Detail, เรื่อง is the classifier for a movie, story or tale.	
ตบมือ	dtòp meu	[to] clap the hands, applaud	
เขียน	kǐan	[to] write	
สนุก	sà-nùk	[to be] fun, enjoyable	
เบื่อ	bèua	[to] be poisoned, give someone poison, [to] be bored (of), be fed up (with)	
สอน	sǒn	[to] teach, instruct, educate	
บางที	baang tee	perhaps, maybe, sometimes, occasionally	
วาด	wâad	[to] draw, sketch, make a drawing, [to] paddle, row a boat	
รูป	rôop	picture, photograph, form, shape, appearance	
ระบาย	rá-baai sěe	[to] paint, colour, daub	[to] paint, [to] release, let out, let off
สีแดง	sěe daeng	[to be] red	
สีีน้ำเงิน	sěe nám ngern	[to be] blue	
ดอกไม้	dòk máai	flower	
สีม่วง	sěe mûang	[to be] purple, violet	
สีชมพู	sěe chom-puu	[to be] pink	
สัตว์	sàd	animal, creature	
สีเขียว	sěe kǐeow	[to be] green	
สีเหลือง	sěe lěuang	[to be] yellow	
สีเทา	sěe tao	[to be] gray	
แมว	maew	cat	
สัตว์์เลี้ยง	sàd líang	pet, domestic animal	
สัปดาห์	sàp-daa	week	
วัน	wan	day	
คือ	keu	[to] be	
วัันอาทิตย์	wan aa-tíd	sunday	
วันจันทร์	wan jan	monday	Monday
วันอังคาร	wan ang-kaan	tuesday	Tuesday
วันพุธ	wan pút	wednesday	Wednesday
วันพฤหัสบดี	wan pá-réu-hàt-sà-bor-dee	Thursday	
วันศุกร์	wan sùk	friday	Friday
วันเสาร์	wan sǎo	saturday	Saturday
หยุด	yùd	[to] stop	
งาน	ngaan	[to] work	work, job, task, event, ceremony, festival, ngan, More Detail, a traditional Thai measurement of area, equal to 400sqm
ทำงาน	tam ngaan	[to] work	
ที่ทำงาน	têe tam ngaan	workplace, office	
ทุ่งนา	tûng naa	field, rice field, farm	
หนัง	nǎng	movie, film, skin, peel	
ตลาด	dtà-làat	market	
มาก	mâak	a lot, many, several	very much, a lot, very
ขาย	kǎai	[to] sell, vend	
คนขาย	kon kǎai	vendor, shopkeeper	
คนซื้อ	kon séu	buyer, shopperpay for	
ระวัง	rá-wang	[to] be careful, watch out for, be cautious	
ทาง	taang	"way, path, route, by, It's a prefix meaning ""in a .... way"", ""relating to..."", ""pertaining to..."""	
แต่งตัว	dtàeng dtua	[to] dress, get dressed, be dressed	
ผูก	pòok	[to] attach, bind, tie	
เก็บ	gèp	[to] keep, store, maintain, [to] collect, gather	
แจกัน	jae-gan	vase	
งาม	ngaam	[to] be beautiful, be good-looking, be pretty	
กวาด	gwàat	[to] sweep, dust, brush	
ต่าง	dtàang	different, various, severaln used when trying to think what to say)	[to] be different, be seperate, differ, different, various, several
ขยะ	kà-yà	waste, garbage, trash	
ข้าง	kâang	next to, at the side of, near, by, side, part	
ซ้าย	sáai	left	
ขวา	kwǎa	right	
บอล	bon	ball	
เชือก	chêuak	rope, string, cord	
ห่าน	hàan	goose, gander	
คิด	kíd	[to] think, consider, calculate, [to] charge, More Detail, a fee or price	
เลข	lâyk	number, numeral, digit	
พับ	páp	[to be] foldable, folding, [to] fold	
กระดาษ	grà-dàat	paper	
รำ	ram	[to] dance (usually implying Thai classical dancing)	rice bran, [to] dance
เพราะ (ไพเราะ)	prór	sweet sound	
แข็งแรง	kǎeng raeng	[to be] strong, healthy	
อย่างไร	yàang rai	how, what, any way, whichever way	
ขอบคุณ	kòp kun	to] thank you, be thankful (for something)	
ถูก	tòok	A marker for putting the following verb in the passive voice	[to be] correct, right, [to be] cheap, inexpensive, [to] conform to, be according to, [to] be pleasing to, be compatible with, [to] hit, strike, [to] touch, It's a marker for putting the following verb in the passive voice, More Detail, a target or goal
ยาย	yaai	grandmother, grandma, grandmamma	
ขนม	kà-nǒm	sweets, candy	
อื่น	èun	another, other, others	
คนอื่น	kon èun	someone else, others	
ขอโทษ	kǒr tôht	"sorry !, excuse me !, [to] apologize, say sorry, More Detail, ขอโทษ is ""sorry"" in the sense of making an apology for ""sorry"" in the sense of offering sympathy เสียใจ is used instead."	
เมื่อวาน	mêua waan	yesterday	
ชน	chon	[to] complete, get close to, near, people, [to] collide with, hit, bump against, [to] fight	
เจ็บ	jèp	[to be] hurt, injured, in pain	
ร้องไห้	róng hâi	[to] cry	
เสมอ	sá-měr	always, constantly, [to be] equal, even, level	
เลิก	lêrk	[to] separate, break up, [to] stop, cease, cancel	
กลับ	glàp	[to] return, go back, reverse	
เกือบ	gèuap	nearly, almost, shortly	
เหยียบ	yìap	almost, nearly, [to] tread (on), step on, trample	
ลูกเป็ด	lôok bpèt	little duck	
กิ๋ว	gìw	a duck sound	
เถียง	tǐang	[to] dispute, debate, argue	
คลอง	klong	canal, waterway, watercourse	
อากาศ	aa-gàat	air, climate, weather	
แดด	dàet	sunlight, sunshine, sunray	
ร้อน	rón	[to be] hot, warm	
สนามเด็กเล่น	sà-nǎam dèk lên	playground	
ริม	rim	foot, base, pedestal	
ถนน	tá-nǒn	road, street, avenue	
ด้าน	dâan	side, area, field, line, [to be] rough, hardened	
ระมัดระวัง	rá mád rá wang	[to] be careful, watch out for, be cautious	[to] be careful, be cautious, take precaution, carefully, cautiously
ทุกอย่าง	túk yàan	everything, every kind, every thing	
ชิงช้า	ching cháa	swing	
แกว่ง	gwàeng	[to] sway, swing, brandish	
แรง	raeng	power, energy, strength, [to be] harsh, strong	
ตก	dtòk	[to] fall, drop (on/down onto/down into)	[to] fade, droop, set, [to] fall, drop
ไม้กระดก	máai grà-dòk	seesaw board, seesaw	
ปีน	bpeen	[to] climb, clamber	
กระดานลื่น	grà daan lêun	slip board, slide board	
แย่ง	yâeng	[to] snatch, grab, seize	
เข้าใจ	kâo jai	[to] understand	
ลม	lom	wind, air	
พัด	lpát	(of the wind) [to] blow	[to] blow, fan
ฝน	fǒn	rain	
รีบ	rêep	quickly, hurriedly, [to] hurry, be in a hurry	
จาก	jàak	from, depart, leave, go away from	
ค่อย	kôi	softly, lightly, gently	quietly, silently, softly lightly, gradually, little, hardly, rarely
กระดก	grà-dòk	[to] tilt, bounce, raise	
บ่าย	bàai	early afternoon (from 1pm to 4pm)	[to] turn, step to one side, early afternoon
หา	hǎa	[to] search for, look for, otherwise, no, not, [to] meet, visit, [to] accuse, blame	
ปลาย	bplaai	tip, point, tail	
แหลม	lǎem	peninsula, cape, promontory, [to be] sharp, pointed	
คนละอัน	kon lá an	each piece, slice, part	
ชั้น	chán	class, rank, grade, layer, level, stage, floor, storey	
เช่นเดียวกัน	chên dieow gan	also, as well, too	
ประตู	bprá-dtuu	door, gate, entrance	
มอง	mong	[to] look (at)	
ชาย	chaai	man, male, [to] glance, edge, fringe, border	
หญิง	yǐng	female, woman	
บ่้านเมือง	bâan meuang	country, state, nation	
ใจ	jai	heart, mind, spirit	
นอกจากนั้น	nôk jàak nán	then, moreover, besides	
โรค	rôhk	disease, illness	
เสียบ	sìap	[to] insert, put in, [to] stab, insert, prick	
หาก	hàak	if	
หมด	mòt	completely, entirely, [to be] finished, used up	
ดังนั้น	dang nán	therefore, in consequence	
แผ่น	pàen	sheet, plate, More Detail, แผ่น is the classifier for flat and thin objects, like CDs, pieces of paper and slices of bread.	
คนเดียว	kon dieow	one person, only person, alone, by oneself	
หลายคน	lǎai kon”	many people	
ต่อ	dtor	continually, further, afterward	next, further on, to, towards, against, for, [to] connect, add on, extend, [to] bargain, haggle, negotiate, [to] resist, fight, complain, wasp
เพียง	piang	only	
เศษ	sàyt	fraction, scraps, remains, fragments	
โน้น	nóhn	that	
ทีนี้	tee née	here now, at present	
สิ้น	sîn	[to] end, finish, stop	
ปี	bpee	year	
ปีหน้า	bpee nâa	next year, coming year	
ใหม่	mài	again, once more, [to be] new, recent, the latest	
พวก	pûak	group, community, party	
ที่สุด	têe sùt	most, maximum, greatest	
ตอบรับ	dtòp ráp	[to] accept, acknowledge, admit	
ลอง	long	[to] try, sample	
สิ่ง	sìng	thing	
หน้าที่	nâa têe	duty, function	
กระดาน	grà-daan	board, plank, batten	
ดังนี้	dang née	as follows	
ศาสนา	sàat-sà-nǎa	religion	
พระมหากษัตริย์	prá-má-hǎa-gà-sàd	great king, king	
รักษา	rák-sǎa	[to] treat, take care (of), [to] maintain, protect, keep	
ประเพณี	bprá-pay-nee	tradition, custom	
บุญคุณ	bun kun	favor, kindness	
ตอบแทน	dtôp taen	[to] requite, reward, compensate	
ระเบียบ	rá-bìap	rule, order, regulation	
อดทน	òd ton	tolerance, forbearance, patience	[to] endure, bear, stand
พยายาม	pá-yaa-yaam	[to] try, endeavour, attempt	
เงิน	ngern	money, currency, cash, silver	
ใช้	chái	[to] use	
ซื่อสัตย์	sêu sàd	[to] be honest, be faithful, loyal	
กล้าหาญ	glâa hǎan	[to be] brave, bold, courageous, bravely, fearlessly, boldly	
ประโยชน์	bprá-yòht	benefit, advantage, usefulness	
ส่วนรวม	sùan ruam	public	
ไทย	tai	thailand	Thailand, Thai, freedom, independence
อย่างนี้	yàang née	like this, in this way	
เจริญ	jà-rern	[to] recite a prayer, chant, pray, [to] prosper, grow, develop	
ความสุข	kwaam sùk	happiness, pleasure	
กล้้า	glâa	[to be] brave, bold	
รับ	ráp	[to] receive, get, accept	
กับข้าว	gàp kâao	things to eat with rice	dishes, course eaten with rice
หิ้ว	hîw	[to] hold, carry	
ตะกร้า	dtà-grâa	basket	
ราคา	raa khaa	price, cost, value	
เลือก	lêuak	[to] choose, select, pick	
แพง	paeng	[to be] expensive, high-priced	
เกิน	gern	excessively, too much, [to] exceed, go beyond	
ผ้า	pâa	cloth, fabric, textile	
หวี	wěe	comb, currycomb, brush, [to] comb, brush, draw a comb through, hand of bananas, cluster of banana	
สบู่	sà-bùu	soap	
เกลือ	gleua	salt, sodium chloride	
มะนาว	má-naao	lemon, lime	
ปลาทู	bplaa-tuu	tuna fish, mackerel	
ไข่	kài	egg, eggs	
ไก่	gài	chicken, hen, cock	
หมู	mǔu	pork, pig	
เนื้อ	néua	"beef, meat, flesh, body, More Detail, ""meat"" here is used both in a literal sense, and in a figurative sense equivalent to ""gist main point essence"". It's comparable to how ""heart"" is used in a similar way in English, e.g. ""the heart of the matter""."	
นั้น	nán	that, those, It's a marker used after a noun or pronoun to emphasize it as the subject of the sentence, or to show the end of a relative clause	
วันพระ	wan prá	Buddhist holy day, Buddhist Sabbath	
เงาะ	ngór	rambutans	
ลำไย	lam-yai	longans	Longan
น้อยหน่า	nói-nà	sugar apple	
สาย	Sǎai	[to be] late, line, More Detail, สาย is the classifier for bus and train lines, roads, ropes and rivers.	
เสร็จ	sѐd	[to] finish, complete, succeed	
หิว	hǐw	[to] be hungry	
ร้าน	ráan	shop, store, booth	
อร่อย	à-ròi	[to be] nice, delicious, tasty	
ป้าย	bpâai	tag	sign, label, notice
บาง	Baang	some, a few, [to be] thin, slim, village, settlement	
น้อย	nói	[to be] few, little, not many	
ผลไม้	pǒn-lá-máai	fruit	
ไกล	glai	far, [to be] far away, distant	
ครัว	krua	kitchen	
เตา	dtao	stove	
ตู้	dtûu	blunt, cabinet, closet	
ข้างฝา	kâng fǎa	side wall	
ผัก	pàk	vegetable	
หม้อ	môr	pot	
กระทะ	grà-tá	pan, frying pan	
ตัก	dtàk	fetch	[to] scoop, dip, draw, lap
ไฟ	fai	light, fire, flame	
ปลูก	bplùuk	[to] grow, plant, cultivate, [to] build, construct, set up	
รด	ród	[to] water, sprinkle, pour	
พริก	prík	chilli	
มะเขือ	má-kěua	eggplant	
แกง	gaeng	[to] make a curry : curry soup	curry, soup, stew, [to] make a curry
แห้ง	hâeng	[to be] dry, dried	
น้ำพริก	nám prík	chili sauce, chili paste, pepper sauce	
ครก	krók	mortar	
ปลา	bplaa	fish	
หญ้า	yâa	grass	
รก	rók	[to be] messy, cluttered, overgrown, placenta, afterbirth	
จอบ	jòp	hoe, weeding tool	
เสียม	sǐam	spade, shovel	
แซะ	sáe	[to] pick out, take out, dig out	
กอ	gor	clump, tussock, grove	
ราก	râak	root, source	
รั้ว	rúa	fence, hedge, rampart	
คางคก	kaang-kók	toad	
แจ่มใส	jàem sǎi	[to be] cheerful, happy, delighted, cheerfully, fine, freshly	
คิดถึง	kíd-těung	[to] miss, think of, think about	
กล่าว	glàao	to] say, tell, speak	
ต้อนรับ	dtôn-ráp	[to] welcome, receive, greet	
(ยิ้ม)แย้ม	(yím) yáem	[to] smile widely	
อ้วน	ûan	[to be] fat, overweight	
ผอม	pǒm	[to be] thin, slim	
นิด	nít	small, a little, a bit	
นุ่ง	nûng	[to] wear (trousers, skirts or other lower-body clothing)	
กางเกง	gaang-geng	trousers, pants, pantaloons	
ทักทาย	ták taai	[to] greet, say hello, address	
แนะนำ	náe nam	[to] introduce, [to] advise, recommend	
สมคิด	sǒm-kíd	person's name	
ดวงแก้ว	duang-gâew	person's name	beloved person, sweetheart, loved one
เก่า	gào	[to be] old, former, previous	
ปรบมือ	bpròp me	[to] clap, applaud	
เพิ่ม	pêrm	to] increase, grow	
หลังจาก	lǎng jàak	after	
(เรื่อง)ราว	(rêuang) raao	anecdote, story	story, tale, account
ตอน	dtorn	a part	when, during, at, section, piece, bit, part, episode
ปิด	bpìd	[to] close, switch off, turn off, [to be] closed, off, shut, [to] hide, conceal, cover up	
เล็ก(น้อย)	lék (nói)	to be] small, little	trifling, trivial, petty, a little, a bit
ภาษา	paa-sǎa	language	
มาแล้ว	maa láew	already come	
เรียก	rîak	[to] be called, be named, [to] call, call out	
งง	ngong	[to be] confused, perplexed	
ตรงไหน	dtrong nǎi	where	
แนะนำ	náe nam	[to] introduce, [to] advise, recommend	
อาจจะ	àat já	might, maybe, may	
พร้อม	próm	at the same time, simultaneously, together, with, together with, [to be] ready, prepared, set	
ดีกว่า	dee gwàa	[to be] better	
เชื่อ	chêua	[to] believe (in), have faith (in)	
คำ	kam	word, words, More Detail, คำ is the classifier for many things that can be spoken or written down - a question, a promise, a translation etc.	
ต่าง ๆ	dtàang dtàang	[to] be different, be seperate, differ	all, all kinds of, a variety of
ป่า	bpà	forest, jungle	
ไร่	râi	farm, field	
แตงโม	dtaeng moh	watermelon	
ชาวนา	chaao naa	farmer, peasant, agriculturist	
จูง	juung	[to] lead, induce, persuade	
วัว	wua	cow, bull, bullock	
ควาย	kwaai	buffalo	
บึง	beung	marsh, swamp	
กว้าง	gwâng	[to be] wide, broad, widely, broadly	
แมลง	má-laeng	insect, bug, beetle	
บิน	bin	[to] fly	
เหนือ	něua	north, northern, over, above, on top of	
กิ้งก่า	gîng-gàa	chameleon, tree lizard	
จ้อง	jông	[to] stare, gaze, look at	
จิ้งเหลน	jîng-lǎyn	skink, scincoid lizard	
อึ่งอ่าง	èung-àang	bullfrog, Rana catesbeiana	
ใบไม้	bai máai	leaf	
ได้ยิน	dâai yin	[to] hear	
จิ้งหรีด	jîng-rèet	cricket, leaping chirping insect	
บัง	bang	[to] conceal, hide, gloss over	
ช้าง	cháng	elephant	
กวาง	gwang	deer, stag, doe	
สวนสัตว์	sǔan sàt	zoo	
ขัง	kǎng	[to] imprison, confine, shut in	
กรง	grong	cell, cage, coop	
รังนก	rang nók	nest, bird 's nest	
กิ่งไม้	gìng máai	branch, twig, bough	
สงสาร	sǒng-sǎan	[to] pity, feel sorry for, sympathize with	
กลัว	glua	[to] be scared, fear	
ที่อยู่	têe yùu	habitat, residence	address, location
รัังผึ้ง	rang pêung	beehive, honeycomb	
ต่อย	dtòi	[to] box, punch, pummel	[to] strike, sting, fight
ผึ้ง	pêung	beehive, honeycomb	
ลูบ	lôop	[to] grope, touch, stroke	
ขน	kǒn	hair, fur, feather, [to] transport, carry, remove	
เรียบ	rîap	[to be] smooth, even, plain	
หยิบ	yìp	[to] pick up, take	
ลููกโป่ง	lûuk-bpòng	balloon	
โอ่ง	òhng	water jar, earthen jar	
น้ำ	nám	water, fluid, liquid	
ส่ง	sòng	[to] send, send something to someone	
สนใจ	sǒn jai	[to] be interested (in)	
ใช่	châi	yes	
ตัวแรก	dtua râek	first, initial, original	
ทองคำ	tong-kam	cat's name	gold
ทองแดง	tong-daeng	cat's name	copper
ไม่ค่อย	mâi kôi	not really, not especially	
สงสัย	sǒng-sǎi	[to] suspect, be suspicious, doubt	
อิ่ม	ìm	[to be] full, full up	
อ่าง	àang	basin, bowl, tub, [to be] stammering, stuttering	
หนู	nŭu	rat, mouse, she, her, you, I, me, More Detail, used by young children, and by women when speaking to their elders	
กลางวัน	glang wan	daytime, day, daylight	
กลางคืน	glang keun	night, nighttime	
เงียบ	ngîap	silently, quietly, softly, [to be] silent, quiet, still	
เกือบ	gèuap	nearly, almost, shortly	
ทุกคืน	túk keun	every night, nightly	
กอง	gong	division, office, bureau, [to] pile up, heap up, accumulate, pile, heap, stack	
ชน	chon	[to] complete, get close to, near, people, [to] collide with, hit, bump against, [to] fight	
กระป๋อง	grà-bpǒng	can, tin	
คอย(เก็บ)	koi gèp	keep on (collect)	
ถุง	tǔng	bag (ถุง is the classifier for bags.)	
กระดาษห่อของ	grà-dàat hòr kǒng	wrap paper	
แตงกวา	dtaeng-gwaa	cucumber	
แบ่ง	bàeng	[to] share, divide out, portion out	
แตก	dtàek	[to] split, break, separate, [to be] broken, cracked, split, [to] sprout, bud, be in bud	
กลอง	glong	drum	
นาฬิกา	naa-lí-gaa	clock, watch, o'clock	
ชั่วโมง	chûa-mohng	hour	
เดือน มิถุนายน	deuan mí-tù-naa-yon	June	
รุ้ง	rúng	rainbow	
โค้ง	kóhng	[to] bow, bend, incline, [to be] curved, bowed, bent	
หาย	hǎai	[to] recover, get well, be cured, [to be] lost, missing, [to] disappear, vanish	
ทิศตะวันตก	tít dtà-wan-dtòk	West	
หน้าต่าง	nâa dtàang	window	
ตรง	dtrong	[to] be in accordance (with), be consistent (with), [to be] straight, direct, directly, straightforwardly, at, [to] be precise at, be exact, be accurate	
คำถาม	kam tǎam	question, query, inquiry	
อธิบาย	à-tí-baai	[to] explain	
ทิี่จริง	têe jing	actually, in fact, in truth	
เรียง	riang	[to] arrange, put in order, line up	
4	sèe	four	
7	jèt	seven	
ตา	dtaa	maternal grandfather, grandfather, mesh, pattern, eye, turn, time, move	
เปล่า	bplào	no, not, [to be] empty, blank, vacant	
ชิด	chít	[to be] close, near	
ปน	bpon	[to] mix, adulterate, mingle	
เย็น	yen	late afternoon, early evening, dusk, [to be] cool, cold	
เกิด	gѐrt	[to] happen, occur, take place, [to] be born, take birth	
แน่	nâe	[to] be sure, be certain	
ฤดูฝน	réu-duu fǒn	rainy season	
เท่านั้น	tâo nán	only, merely, simply	
แล้ง	láeng	to] be arid, be dry, have dry weather	drought
แสงแดด	sǎeng dàet	sunlight, sunshine, sunbeam	
หน้าแล้ง	nâa láeng	dry season	
หน้าฝน	nâa fǒn	rainy season	
อ่อน	òn	[to be] weak, feeble, submissive, [to be] tender, soft, [to be] young, immature, inexperienced	
ค้าน	káan	[to] oppose, protest, dissent	
ก้าน	gâan	stem, stalk	
เป่า	bpào	[to] blow	
ฟอง	fong	bubble, foam	
ครั้ง	kráng	time, occasion	
ห้าม	hâam	[to] forbid, prohibit, disallow	
พรุ่งนี้	prûng-née	tomorrow, the next day	
กรุงเทพ	grung tâyp	Bangkok, Krung Thep	
ใจดี	jai dee	[to be] kind-hearted, kind, generous	
จังเลย	jang	so much, extremely, greatly, More Detail, จังเลย is more commonly used by female speakers than males.	
สิ่งของ	sìng kǒng	thing, article, matter	
จำเป็น	jam bpen	have to, must, need to	
สั่ง	sàng	[to] order, command, direct	
เช่น	chên	for example, for instance	
แปรง	bpraeng	brush, scrub, [to] brush, scrub, clean	
ยาสีฟัน	yaa-sěe-fan	toothpaste	
เสื้อผ้า	sêua-pâa	clothes	
ของใช้	kǒng chái	appliance, utensils, wares	
ใหญ่	yài	[to be] big, large, great	
ใบ	bai	paper, sheet, document, sail, leaf, More Detail, ใบ is a classifier for fruit and eggs, general types of containers (bags, boxes, bowls, buckets, cans, cups etc), and also for pieces of paper, documents and tickets.	
แผนที่	pǎen-têe	map	
พัก	pák	for a while, for a time, [to] stay, rest, break	
เดินทาง	dern taang	[to] travel, tour, take a trip, travel, journey	
อาหาร	bpìn-dtoh	food	
ปิ่นโต	aa-hǎan	food carrier, tiffin carrier	
รถยนต์	rót-yon	automobile, motorcar, car	
สถานีรถไฟ	sá-tǎa-nee rót-fa	railway station	
แต่ก่อน	dtàe-gòn	before, formerly, previously	
ฟืน	feun	firewood	
แล่น	lâen	[to] run, move, glide	
สะพาน	sá-paan	bridge, flyover	
แผ่นดิน	pàen-din	land, territory, country	
เตือน	dteuan	[to] remind, warn, advise	
ยื่น	yêun	[to] interfere, intervene	[to] extend, project
แขน	kǎen	arm, limb	
นอก	nôk	outside, outdoor, external, outward	
อันตราย	an-dtà-raai	danger, hazard, [to be] dangerous	
แม่น้ำ	mâe-nám	river, waterway	
ชาวสวน	chaao-sǔan	orchardist, fruit gardener	
เมือง	meuang	city, town, state	
น่าอยู่	nâa yùu	[to be] livable, habitable, pleasant	
ท่อง	tông	to] memorize, remember, learn by heart	[to] recite, memorize, learn by heart, [to] wander, roam around, rove around
มีค่า	mee kâa	[to be] valuable, precious	
ผืน	pěun	land, ground, terra firma	sheet
ได้ผล	dâai pǒn	[to] be effective, work	
จน	jon	until, till, [to be] poor, impoverished, broke	
กุ้ง	gung	shrimp, prawn, crayfish	
ทรัพย์	sáp	property, wealth, money	
ดิน	din	earth, land, ground	
ได้ยิน	dâai yin	[to] hear	
ปู่	bpùu	grandfather, grandpa, paternal grandfather	
ย่อม	yôm	likely to, liable to, naturally will, [to be] smallish, light, little	
เครื่องบิน	krêuang bin	plane, aircraft, aeroplane	
จำนวน	jam nuan	amount, quantity, sum	
ลำ	lam	trunk, body, stalk (ลำ is the classifier for planes or boats	
จอด	jòt	[to] park, moor, stop	
ขับ	kàp	[to] drive, ride	
คอย	koi	[to] wait, await, keep on (doing something)	
รับ	ráp	[to] receive, get, accept	
อ่อนน้อม	òn nóm	[to] submit (to someone), surrender (to someone), [to] be respectful (to), be courteous (to)	
ใหญ่	yài	[to be] big, large, great	
ชนิด	chá-nít	kind, sort, type, More Detail, ชนิด is a classifier for a type, sort or kind of something.	
รถโดยสาร	rót doi sǎan	bus, coach	
ประจำทาง	bprá-jam-taang	[to be] regular, usual, fixed	
รถบรรทุก	rót ban-túk	truck, lorry, van	
เต็ม	dtem	[to be] full	
ควัน	kwan	smoke, fumes	
กลิ่น	glìn	smell, odor, scent	
เหม็น	měn	[to] smell, stink, [to be] bad smelling, offensive smelling	
หายใจ	hâai jai	to] breathe	
เปลี่ยน	bplìan	[to] change, transform, vary	
ข้าม	kâam	[to] cross over, pass over, overlook	
กลุ่ม	glùm	group, community, crowd	
สินค้า	sǐn káa	goods, merchandise, commodity	
หลุม	lǔm	hole, pit, hollow	
ซ่อม	sôm	[to] repair, mend, restore	
ชุมชน	chum chon	community, crowd, mass	
หอม	hǒm	fragrant, aroma, scent	"[to be] pleasant-smelling, sweet-smelling, [to] kiss, ""sniff kiss"", More Detail, A ""sniff kiss"" is a traditional Thai way of showing affection to a loved one, and involves putting your nose to someone's cheek and gently inhaling. It's regarded as as more discrete and more acceptable in public than a western style kiss (จูบ)."
ดื่ม	dѐum	[to] drink	
ส้ม	sôm	[to be] sour, acidic, orange	
หลาน	lǎan	grandchild	
รับประทาน	ráp-bprà-taan	[to] eat	
ถาด	tàad	tray, salver	
ละมุด	lá-mút	sapodilla, a fruit	sapodilla, Manilkara zapota
สับปะรด	sàp-bpà-rót	pineapple	
มีด	mêet	knife, cutter, blade	
มีืด	mêut	[to be] dark	
ไม้ขีด	máai kѐet	match	
ตะเกียง	dtà-giang	lamp, lantern	
สว่าง	sà-wàang	[to] be bright, be brilliant, be blazing	
โทรทัศน์	toh-rá-tát	television, TV	
วิทยุ	wít-tá-yú	radio	
พระแก้วมรกต	prá gâew mor-rá-gòt	Buddha image 's name	Emerald Buddha
ละเอียด	lá-ìat	[to be] detailed, thorough, thoroughly, carefully, meticulously	
ตำรวจ	dtam-rùat	police, policeman	
ปฏิบัติ	bpá-dtî-bàt	[to] perform, carry out, apply	
ติด	dtit	[to] start, set, [to be] stuck, jammed, [to] stick, attach, [to] be addicted to, crazy about, fascinated with, [to be] addictive, [to] owe, be in debt, [to] be attached to, be connected to, [to] catch, be infected, become infected	
ขัด	kàt	[to] go against, cross, be opposed to	
ผิด	pìt	[to be] wrong, incorrect	
กฏหมาย	gòt-mǎai	law	
ความสงบ	kwaam sá-ngòp	peace, tranquility	
ภายใน	paai nai	inside, interior, internal	
ประเทศ	bprà-tâyt	country, nation, state	
ทางข้าม	taang kâam	crosswalk	
ร้าย	ráai	[to be] bad, evil	
ฉลาด	chá-làat	clever, intelligent	
โยน	yohn	[to] throw, pitch, toss	
ว่าย	wâai	[to] swim	
หัวหน้า	hǔa nâa	boss, leader, chief	
ความเคารพ	kwaam kao-róp	respect, regard, esteem	
กราบ	gràap	[to] prostrate oneself	
กระดานดำ	grà-daan dam	blackboard, chalkboard, greenboard	
ตัวหนังสือ	dtua nǎng-sěu	character, letter, writing	
ครบ	króp	altogether, completely, wholly	
บรรทัด	ban-tát	straight line, straight edge, ruler	
ยาก	yâak	[to be] hard, difficult	
ฟัง	fang	[to] listen (to something), hear (something)	
คุณสมบัติ	kun-ná-sǒm	characteristic, qualification, attribute	
ซ้ำ	sám	repeatedly, [to] repeat, [to be] repeated, recurrent	
คำสั่ง	kam sàng	command, order, word of command	
ข้อบังคับ	kôr bang-káp	regulation, rule, principle	
เตือนใจ	dteuan jai	[to] remind, call to mind, [to be] memorable, recognizable	
ครบ	króp	altogether, completely, wholly	
ถูกต้อง	tùuk dtông	[to be] correct, right, accurate	
ภาพ	pâap	picture, image, vision	
เปรียบ	bprìap	[to] compare, make a comparison	
ครอบครัว	krôp krua	family	
นับถือ	náp těu	[to] respect, believe in	
กำลังใจ	gam-lang jai	spirit, moral support, will	
รวม	ruam	[to] combine, add up, include	
พระเจ้าแผ่นดิน	prá jâo pàen din	king, monarch, sovereign	
หรือ	rěu	or, It's a question particle used when seeking confirmation of something thought to be true, or to make a question sound softer	
ในหลวง	nai lǔang	king	
ทั้งหมด	táng mòt	absolutely, all, total	
นัับถือ	náp těu	[to] respect, believe in	
ทหาร	tá-hǎan	military, soldier	
รบ	róp	[to] fight, combat	
ยิง	ying	[to] shoot, fire	
ปืน	bpeun	gun, firearm, rifle	
ป้องกัน	bpông gan	[to] protect, defend, prevent	
หมอ	mǒr	guy, fellow, doctor	
ควร	kuan	should, ought to	
สุภาพ	sù-pâap	politely, courteously, respectfully, [to be] polite, courteous, well-mannered	
อาชีพ	aa-chêep	career, profession, livelihood	
ขนมตาล	kà-nǒm dtaan	Thai sweet made from sugar palm	
โรย	roi	[to] sprinkle, scatter, [to] wither, fade, wilt	
ชิ้น	chín	piece, part ,	piece, part, fragment, More Detail, ชิ้น is the classifier for a piece of something - cloth, meat, fruit etc.
แกะ	gàe	[to] unwrap, unpack, unbind, sheep, ewe, ram, [to] engrave, etch, carve	
ก้อน	gôn	piece, chunk	
น้ำตาล	nám dtaan	brown, sugar	
ชาม	chaam	bowl	
เดือด	dèuat	[to] boil, froth, foam, [to be] angry, boiling mad	
คลาน	klaan	[to] move slowly, crawl	
ขันน้ำ	kǎn nám	bowl	
ถ้วยแก้ว	tûay gâew	glass, cup, crystal	
นั่น	nân	that, those	
ของใคร	kǒng krai	whose, of someone, of anyone	
ให้ยืม	hâi yeum	[to] lend	
ขาด	kàat	[to] lack, need, miss, completely, absolutely, [to be] lacking, [to be] broken, separated, torn, [to be] final	
ขนมกล้วย	kà-nǒm glûay	Thai sweet made from banana	
ขนมเทียน	kà-nǒm tian	Thai sweet made from bean	
ข้าวเหนียวเปียก	kâao nǐeow bpìak	Thai sweet made from sticky rice	
ขนมบัวลอย	kà-nǒm bua loi	Thai sweet made from sticky rice flour	Bua Loi
ส่วนมาก	sùan mâak	mostly, chiefly, largely	
แป้ง	bpâeng	wheat flour	
น้ำตาล	náam dtaan	brown, sugar	
ส่้อม	sóm	fork	
เขี่ย	kìa	[to] stir, scratch, [to] scrape away, throw away, flick off	
ปั้น	bpân	[to] mold, sculpt, form, lump, mass	
เติม	dterm	[to] add, add more, fill	
ถ่าน	tàan	charcoal, cinder	
จวน	juan	nearly, almost, practically, It's the name of the official residence of the governer of a province	
ดับ	dàp	[to] switch off, turn off, put out	
เลื่อน	lêuan	[to] postphone, delay, put-off, [to] promote, upgrade, [to] slip, slide, skid	
สดชื่น	sòt chêun	[to] be happy, be pleased, be delighted, [to] be fresh, be lively, be vigorous	
เรือ	reua	boat, ship, rook	
ใส	sǎi	[to be] clear, transparent	
ไหล	lǎi	[to] flow	
ข้าม	kâam	[to] cross over, pass over, overlook	
ผ่าน	pàan	[to] pass, pass over, pass by	
สถานีตำรวจ	sà-tǎa-nee dtam-rùat	police station	
ทราย	saai	sand	
อิฐ	ìt	brick	
หัก	hàk	[to] subtract, deduct, [to be] broken, split, [to] break, crack, break off	
พระสงฆ์	prá sǒng	monk, Buddhist priest	
กิริยา	gì-rí-yaa	manners, behaviour, behavior	
มารยาท	maa-rá-yâat	manners, ethics	
ตำบล	dtam-bon	"Tambon, More Detail, A ""Tambon"" is a local government administrative district in Thailand, often translated as ""subdistrict"" in English. It's a subdivision of an อำเภอ (district), which itself is a subdivision of a จังหวัด (province). There are 7254 Tambon in Thailand, located in every province except for Bangkok, which has the equivalent เขต instead."	
ของสด	kǒng sòt	fresh food, uncooked food	
บุหรี่	bù rèe	cigarette, tobacco	
กาแฟ	gaa fae	coffee	
เรืือ	reua	boat, ship	
เรือโยง	reua yohng	tugboat, tug, towboat	
บรรทุก	ban-túk	[to] fill up with, load up with, carry	
ข้าวเปลือก	kâao bplèuak	unhusked rice	
ข้าวสาร	kâao sǎan	rice	
แยก	yâek	[to] divide, separate, part	
สกปรก	sòk-gà-bpròk	[to be] dirty, messy, unclean	
พิษ	pít	poison, toxicity, toxicant	
ปัก	bpàk	[to] stick, plunge down, stab down, [to] embroider	
เสีย	sǐa	[to be] bad, spoiled, wasted, [to] lose, waste, spoil, [to] discard, give up, [to be] passed away, dead, [to] pay, More Detail, implying an imposed fee that must be paid, even if it has little direct benefit to the payer, It's a particle implying the verb should be done quickly or completely	
เงิน	ngern	money, currency, cash, silver	
บาท	bàat	(the Thai currency,	baht, line, foot, feet, More Detail, the Thai currency, Baht is also a unit of measurement for gold equal to 15.16 grams
สาธารณะ	sǎa-taa-rá-ná	public	
สมบัติ	sǒm-bàt	property, wealth, asset	
โคลน	klohn	mud, mire, muck	
ปา	paa	[to] throw, pitch	
ฝั่ง	fàng	coast, bank, side (of a river or sea)	
ซักผ้า	sák pâa	[to] wash, do one's washing	
ผลัด	plàt	[to] change clothes	[to] alternate, take turns, shift, turn
วันเข้าพรรษา	wan kâo pan-sǎa	a day start for thai monk to stay in temple  in period of 3 lunar months during the rainy season	"Khao Phansa Day, More Detail, a national holiday which marks the start of ""phansa"", a period of 3 lunar months during the rainy season when Buddhist monks retreat to their temples for Dharma study and avoid any unnecessary travel."
ประชาชน	bprà-chaa-chon	people, inhabitants, residents	
ทำบุญ	tam bun	[to] make merit	
ศาลา	sǎa-laa	pavilion, wayside shelter, hall	
สำคัญ	sǎm-kan	[to be] important, significant	
พระฉัน	prá chǎn	The monk have eating	
ผู้ใหญ่บ้าน	pûu yài bâan	village chief, village headman	
แจ้ง	jâeng	[to] inform, tell, advise, [to be] clear, open, unobscured	
ทราบ	sâap	to] know, understand, realize	
เชิญ	chern	[to] invite, ask, persuade	
อำเภอ	am-per	district, amphoe	
ชาวบ้าน	chaao bâan	villager, folk, ordinary people	
ร่วมมือ	rûam meu	[to] cooperate, collaborate, work together	
กำแพง	gam-paeng	wall, barrier, partition	
ลูกเสือ	lûuk sěua	boy scout	
เสีย	sǐa	[to be] bad, spoiled, wasted, [to] lose, waste, spoil, [to] discard, give up, [to be] passed away, dead, [to] pay, More Detail, implying an imposed fee that must be paid, even if it has little direct benefit to the payer, It's a particle implying the verb should be done quickly or completely	
มนุษย์	má-nút	human, human being	
ตาย	dtaai	[to] die, pass away, [to be] dead	
พืช	pêut	vegetation, plant	
คำขวัญ	kam kwǎn	slogan, motto, catchword	
ชีวิต	chee-wít	life, existence, living	
สั้น	sân	[to be] short, brief, shortly, briefly	
กัน	gan	one another, each other, together, jointly, [to] keep out, prevent, set aside	
แก้	gâe	[to] fix, solve, rectify, [to] untie, loosen, undo	
ถาง	tǎang	[to] mow, clear, cut	
ไม้ไผ่	máai pài	bamboo	
ขนลง	kǒn long	[to] carry down	
แจก	jàek	[to] distribute, give out, hand out	
กุหลาบ	gù-làap	rose	
ดอก	dòk	flower bloom	flower, interest
บูชา	buu-chaa	[to] worship, venerate, revere	
ผล	pǒn	result, effect, consequence, fruit	
หนา	nǎa	[to] overcrowd, be dense, be crowded	[to be] thick, dense
ร่่มเงา	rôm ngao	tree shade, shade	
อาศัย	aa-sǎi	[to] depend upon, [to] live, reside, dwell	
เต็มใจ	dtem jai	mâi sà-baai	be willing to, like, with one's will, willingly
ไม่สบาย	mâi sà-baai	[to] be ill, be unwell	
ยอม	yom	[to] agree, consent, let	
ท่าทาง	tâa taang	look, manner, appearance	
รื่นเริง	rêun rerng	[to be] enjoyable, joyful, cheerful, enjoyably, joyfully, cheerfully	
ฝัง	fǎng	[to] bury a dead body, bury a corpse	[to] bury, inter
โคน	khon	trunk (of a plant)	base, bottom, root
เสียใจ	sǐa jai	[to be] sorry, upset, apologetic	
เหลือเกิน	lěua gern	very much, too much, extremely	
น้ำตา	náam dtaa	tears	
เช็ด	chét	[to] wipe, rub, clean	
ป่วย	bpùay	[to] sick, ill, get ill	
เป็นอะไร	bpen à-rai	"[to] have something wrong, have a problem, More Detail, Although the literally meaning of เป็นอะไร is closer to ""what are you?"" it's frequently used as a phrase by itself to mean ""What's wrong ?"". To reply there's nothing wrong you can use ไม่เป็นอะไร (or the shortened form ไม่เป็นไร), though the literal meaning often invites sarcastic replies like เป็นคน (""I'm a person"")."	
เอง	ayng	only, alone, just	
ตรวจ	dtrùat	[to] check, censor, inspect	
ฉีดยา	chèet yaa	[to] inject, vaccinate, inoculate	
โรงพยาบาล	rohng pá-yaa baan	hospital	
ไม่เช่นนั้น	mâi chên nán	otherwise	
ติดโรค	dtìt rôhk	[to] contract a disease, infect with a disease	
ปลูกฝี	bplùuk fěe	[to] vaccinate, inoculate	
ระบาด	rá-bàat	[to] spread, be dispersed, be scattered	
ท่ี่แล้ว	têe láew	last time, pass, already	
เยี่ยม	yîam	[to] visit, go to see, call on, [to be] excellent, superb, outstanding	
ญาติ	yâat	relatives, relations, folks	
ต่างจังหวัด	dtàang jang-wàt	[to be] provincial, up-country, out of town	
ก่อน	gòn	before, first, former	
แขนเสื้อ	kǎen sêua	sleeve	
ปฏิทิน	bpà-dtì-tin	calendar	
หวัด	wàt	cold, common cold	
ตาแดง	dtaa daeng	conjunctivitis, pink eye	
หิด	hìt	scabies, itch	
เหา	hǎo	lice, louse	
ปวด	bpùat	[to] ache, pain	
ศีรษะ	sěe-sà	head	
รู้สึก	rúu sèuk	[to] feel, touch	
คัดจมูก	kát jà-mùuk	[to] have a stuffed nose	
ยา	yaa	medicine, medication, drug	
ร้านขายยา	ráan kǎai yaa	pharmacy, chemist, drugstore	
ผ้าเช็ดหน้า	pâa chét-nâa	handkerchief	
จมุก	jà-mùuk	nose	
จาม	jam	[to] sneeze, sniff, [to] ax, hew, strike, Cham	
รด	rót	sneeze over the other person	[to] water, sprinkle, pour
สั่งยา	sàng yaa	[to] give a prescription	
กลาง	glaang	center, middle, [to be] central, medium	
น้ำแข็ง	nám kǎeng	ice	
ของชอบ	kǒng chôp	[to] admire, like ,favorite	
สุขภาพ	sùk-kà-pâap	health, wellbeing, good condition	
ประจำ	bprà-jam	[to] be stationed, be posted	[to be] regular, usual, fixed, regularly, frequently, constantly
ไข้	kâi	fever	
ห่ม	hòm	[to] cover, enclose, wrap	
หนาว	nǎao	[to be] cold, cool	
ปวดท้อง	bpùat tóng	[to] have a stomachache	
พุทรา	pút-saa	Name of Thai fruit Tree	
กระจก	grà-jòk	mirror	
บาด	bàat	[to] cut	
เท้า	táo	[to] refer, allude, mention, foot, [to] lean on, rest on, prop up	
หาม	hǎam	[to] carry, take	
เย็บ	yép	[to] sew	
แผล	plǎe	wound, cut	
อุ้ม	ûm	[to] carry, hold	
จำได้	jam dâai	[to] remember, recollect, recall	
สร้าง	sâang	[to] create, produce, build	
ต้นไทร	dtôn trai	banyan tree, Banyan Tree, More Detail, Scientific Name:Ficus Bengalensis	
ยากจน	yâak jon	[to be] poor, impoverished, broke	
สามารถ	sǎa-mâat	capability, ability, talent	can, be able to
ผอม	pǒm	[to be] thin, slim	
หน้าตา	nâa dtaa	face, appearance	
เหลือง	lěuang	[to be] yellow	
เสื้อผ้า	sêua pâa	clothes	
หลับ	làp	[to] sleep, be asleep	
ดูด	dùut	[to] suck, absorb, inhale	
นิ้ว	níw	finger, toe, digit, inch	
รอย	roi	scratch, mark, trail	
ยุง	yung	mosquito	
กัด	gàt	[to] bite, nip, nibble, [to] quarrel, fight, be at odds, [to] corrode, erode	
กาง	gaang	[to] spread out, stretch out, hang out	
มุ้ง	múng	mosquito net, net, mosquito bar	
เป็นแถว ๆ	bpen tăew	be in line/ row	
ชั้นสูง	chán sŏong	high grade/level	high level, high class, higher grade
แต่ละ	dtàe lá	each	
ผู้คอย	pôo	a person who (do something)	
ควบคุม	kûap kum	[to] control, command, govern	
ปลอดภัย	bplòt pai	savety	[to] be safe, be out of danger, be free from harm
ทางเดียวกัน		same direction	
แยกไป	yâek	seperate	
อีกทางหนึ่ง	èek	another way	
ไปส่ง	bpai	go with	
คนอื่น	kon èun	other person	someone else, others
มุมถนน	mum tà-nŏn	conner	corner, street corner
มุงดู	mung	crowd watching around	
ชกต่อย	chók dtòi	fighting	[to] box, punch, pummel
ห้าม	hâam	stop	[to] forbid, prohibit, disallow
ความสงบ	kwaam sà-ngòp	peace, tranquility	
ทะเลาะ	tá-lór	[to] argue, quarrel, fight	
ไม่มีประโยชน์	mâi	useless	
สอบสวน	sòp sŭan	[to] investigate, search, inspect	
ผิดกฏหมาย	pìt	illegal	
นกหวีด	nók wèet	whistle	
หนังสือพิมพ์	năng-sĕu pim	newspaper, paper, press	
ผู้ร้าย	pôo ráai	criminal, offender, culprit	
ขโมย	kà-moi	thieft	thief, pilferer, burglar, [to] steal, thieve, pinch
หลีกเลี่ยง	lèek lîang	[to] avoid, evade	
ฝ่าฝืน	fàa fĕun	[to] break, infringe, violate	
อาหารเย็น	aa-hăan yen	dinner	
ปากกา	bpàak gaa	pen	
ประชุม	bprà-chum	meetin/conference	[to] meet, hold a meeting, gather
อำเภอ	am-per	distric office	district, amphoe
นายอำเภอ	naai am-per	sheriff, district-chief officer	
ข้าราชการ	kâa râat-chá-gaan	goverment officer	government officer, government employee
ธรรมดา	tam-má-daa	[to be] ordinary, common, usual, normally, usually, ordinarily	
สำคัญ	săm-kan	[to be] important, significant	
ความเป็นอยู่	kwaam bpen yòo	livelihood, living, subsistence	
คำสั่ง	kam sàng	command, order, word of command	
รัฐบาล	rát-tà-baan	goverment	government
โรงพยาบาล	rohng pá-yaa-baan	hospital	
ที่ทำการไปรษณีย์	têe tam gaan bprai-sà-nee	post office	
ไปรษณีย์	bprai-sà-nee	post / mail	post, mail
ตู้ไปรษณีย์	dtôo bprai-sà-nee	post box	mailbox, postbox, letter box
จดหมาย	jòt măai	letter,mail	letter, correspondence, mail
เดี๋ยวนี้	dĭeow née	at this moment, now, instantly	
ตอนเช้า	dton-cháo	in the morning	morning, early morning
กุญแจ	gun-jae	key, lock, latchkey	
ไข	kăi	unlock/open	fat, grease, [to] wind, turn, [to] reveal, expose, explain
ดวงตราไปรษณีย์	duang dtraa	stamp	
โดนปรับ	dohn	impose a fine	
เมื่อคืน	mêua keun	last night	
งานวัด	ngaan wát	temple fair	
ยกมือ	yók meu	raise hand up	[to] agree, accept, concur
เพลง	playng	song	
แขวน	kwăen	[to] hang, suspend	
ธูป	tôop	joss stick, incense	
เทียน	tian	candle	
ฟุ้ง	fúng	blow in the wind	too much, too many, [to] spread, diffuse, blow
ร้านขายของ	ráan kăai kŏng	the booth	store, shop
ปิดทอง	bpìt tong	stick a gold leave	[to] gild, cover with gold leaf
แปลก	bplàek	difference/strange	[to be] strange, odd, weird
หมวก	mùak	hat	
เข็มขัด	kĕm kàt	belt, girdle	
เครื่องดนตรี	krêuang don-dtree	musical instrument, musical equipment	
ดาบ	dàap	sword, sabre, saber	
ปี่	bpèe	book-4 flute	flute, pipe, wind instrument
ลูกบอล	lôok bon	ball	
ตุ๊กตา	dtúk-gà-dtaa	doll, toy	
วันหลัง	wan lăng	next day	future, following day, later
ลิเก	lí-gay	a kind of Thai dancing	likay
รำ	ram	a kind of Thai dancing	rice bran, [to] dance
รบ	róp	[to] fight, combat	
ประเดี๋ยวหนึ่ง	bprà-dĭeow	for a while	
รำวง	ram-wong	a kind of Thai dancing	Thai folk dance, [to] perform Thai folk dance
หนุ่มสาว	nùm săao	yong people	young people, teenagers
คู่	kôo	[to] match, be paired with, couple, pair, spouse, More Detail, คู่ is the classifier for a pair of something - e.g. socks, shoes, lovers/married couples.	
โขน	kŏhn	a kind of Thai performance	Khon, More Detail, a type of Thai drama
ละคร	lá-kon	a kind of Thai performance	play, stage performance, drama
ดึก	dèuk	late at night	
น้ำหวาน	náam wăan	sweet drink	soft drink
การแสดง	gaan sà-daeng	performance	
ลำตัด	lam-dtàt	a kind of Thai performance	antiphonal singing
การบ้าน	gaan bâan	homework, assignment, schoolwork	
ล้อ	lór	wheel, roller, caster, [to] tease, joke, make fun of	
ยาง	yaang	tire, rubber	
เครื่องยนต์	krêuang yon	engine, motor, machine	
น้ำมัน	náam man	oil, gasoline	
เจาะรู	jòr roo	punch	
หลังคา	lăng kaa	roof, rooftop	
หิน	hĭn	rock, stone, boulder	
ขีดเส้น	kèet sâyn	[to] draw a line, [to] stipulate, specify, settle	
หลุม	lŭm	hole, pit, hollow	
บ่อ	bòr	hole, pit ,	well, waterhole, pit, mine
กล่อง	glòng	box, case, casket	
ลาก	lâak	[to] drag	
เหนื่อย	nèuay	[to be] tired	
ชนะ	chá-ná	[to] win, beat, defeat	
แพ้	páe	[to] lose (someone)	[to] be defeated (by someone), lose (to someone), [to] be allergic to
ชายทะเล	chaai tá-lay	seaside, seashore, beach	
เปลือกหอย	bplèuak hŏi	shell parakeet	
ชายหาด	chaai hàat	beach, seashore, seaside	
ฟาง	faang	[to be] dim, blurred, straw, rice straw, regrown tooth, third tooth	
ขวด	kùat	bottle, More Detail, ขวด is the classifier for bottles or anything that comes in a bottle.	
เปลือกไข่	bplèuak kài	egg shell	
สีดำ	sĕe dam	[to be] black	
กาว	gaao	glue, gum, mucilage	
แตก	dtàek	breakage, separation	[to] split, break, separate, [to be] broken, cracked, split, [to] sprout, bud, be in bud
เปื้อน	bpêuan	[to] dirty, stain, soil, [to be] stained, dirty, spattered	
เดิม	derm	origin, beginning, previous, former, primary	
กีดขวาง	gèet kwăang	[to] obstruct, hinder, block	
หลอดไฟ	lòt fai	light bulb, incandescent lamp	
มวย	muay	knot, bun, chignon, boxing	
การ์ตูน	gaa-dtoon	cartoon	
ข่าว	kàao	news, information	
เหตุการณ์	hàyt gaan	event, incident, episode	
เตารีด	dtao rêet	iron	
พัดลม	pát lom	electrical fan	
ตู้เย็น	dtôo yen	refrigerator, freezer	
หม้อหุงข้าว	môr hŭng kâao	rice cooker	
ไฟฉาย	fai chăai	flashlight, searchlight, electric torch	
โรงไฟฟ้า	rohng fai fáa	power station	power plant, powerhouse
สาธารณะ	săa-taa-rá-ná	public	
เดือนกรกฏาคม	deuan	July	
นกเอี้ยง	nók-îang	brown headed cowbird	
นกยูง	nók-yoong	peacock	
กอไผ่		clump of bamboo	
ว่าว	wâao	kite	
ข้าวหลาม	kâao lăam dtàt	glutinous rice roasted in bamboo joints	
กังหัน	gang-hăn	turbine, windmill, wind-wheel	
ด้าม	dâam	handle, shaft, hilt	
กาฝาก	gaa-fàak	parasite plant	
กล้วยไม้	glûay mái	orchid	
เข็ด	kèt	[to] be afraid, be scared, fear	
ผึ้ง	pêung	bee	
แห้ง	hâeng	[to be] dry, dried	
ด้ิ้น		[to] wriggle, writhe, squirm	
ล้าง	láang	[to] wash clothes, launder, clean	
ปลาช่อน	bplaa chôn	striped snake-head fish	
ปลาหมอ	bplaa mŏr cháang yìap	a kind of thai fish	
ปลาดุก	bplaa-dùk	walking catfish	Clarias
คู	koo	ditch, gutter, trench	
เที่ยง	tîang	[to be] accurate, exact, precise, noon, midday	
ปีกลาย	bpee glaai	previous year, last year	
ลึก	léuk	deeply, profoundly, reconditely, [to be] deep	
กบ	gòp	frog, plane, carpenter's plane	
เต่า	dtào	turtle, tortoise, terrapin	
ไหม้	mâi	[to] burn, be on fire, be ablaze, [to be] burnt, scorched, charred	
ต้ม	dtôm	[to be] boiled, [to] boil, [to] cheat, con	
เพลิน	plern	to enjoy, to be entertained	[to] enjoy, be absorbed, be entertained, jubilantly, joyously, merrily
เดือด	dèuat	[to] boil, froth, foam, [to be] angry, boiling mad	
ไอน้ำ	ai náam	steam	
กา(ต้มน้ำ)	gaa dtôm náam	kettle, teakettle, pot	
ค่ำ	kâm	evening, night, night-time	
ทิศตะวันออก	tít dtà-wan òk	east	
พระจันทร์	prá jan	moon	
ดวงจันทร์	duang jan	moon, lunar	
เต็มดวง	dtem duang	full moon	[to] be full
ขอบฟ้า	kòp fáa	horizon, skyline	
กลาง	glaang	center, middle, [to be] central, medium	
ท้องฟ้า	tóng fáa	sky	
หนุน	nŭn	[to] support, prop up, back up,	
หมอน	mŏn	pillow	
ชาน	chaan	platform, porch	
ข้าง	kâang	beside	next to, at the side of, near, by, side, part
กระต่าย	grà-dtàai	rabbit, coconut grater	
แหวน	wăen	ring, hoop, circle	
ทองแดง	tong daeng	copper	
ห้องสมุด	hông sà-mùt	library	
ชีวิต	chee-wít	life, existence, living	
เหว	wăy	life, existence, living	abyss, chasm, gorge
โลก	lôhk	world, earth	
เงา	ngao	shadow, reflection, image	
แต่ง	dtàeng	invent a story	[to] compose, write, [to] decorate, beautify, adorn, [to] prepare, organize, arrange
ดาว	daao	star	
หาย	hăai	gone	[to] recover, get well, be cured, [to be] lost, missing, [to] disappear, vanish
แสงจันทร์	săeng jan	moonlight	
แสงดาว	săeng	starlight	
แสงอาทิตย์	săeng aa-tít	sunlight	sun light
เมฆ	mâyk	cloud	
ลอย	loi	[to] float, drift	
บัง	bang	[to] conceal, hide, gloss over	
เดือน	deuan	month, moon	
เดืือนพฤษภาคม	deuan préut-sà-paa kom	May	
เดือนพฤศจิกายน	deuan préut-sà-jì-gaa-yon	November	
ฤดูฝน	réu-doo fŏn	rainy season	
ฤดููร้อน	réu-doo rón	summer season	
ฤดูหนาว	réu-doo năao	winter season	
เดือนเมษายน	deuan may-săa-yon	April	
เดือนกุมภาพันธ์	deuan gum-paa pan	Febuary	February
ต่ำ	dtàm	[to be] low	
หยด	yòt	[to] drop	
หาว	hăao	sky, open air, [to] yawn	
ง่วง	ngûang	[to] be tired, be sleepy	
ก่อน	gòn	previous, before	before, first, former
สุดท้าย	sùt táai	last, final, finally, lastly	
คัด	kát	[to] handwrite, write in longhand	[to] steer, helm, take the tiller, [to] select, pick, choose, [to] copy, transcribe, excerpt, [to be] congested, clogged up
บทเรียน	bòt rian	Lesson	lesson
แบบฝึกหัด	bàep fèuk hàt	exercise, practice	
คัั่น	kân	[to] separate, divide, interpose	
วันที่	wan têe	Date	date, the day that
ตัวอย่าง	dtua yàang	Example	example, instance, sample
กระซิบ	grà-síp	[to] whisper, murmur, mutter	
ปลูก	bplòok	to] cultivate, plant, grow	[to] grow, plant, cultivate, [to] build, construct, set up
นัด	nát	appointment, [to] have an appointment, date, round, More Detail, The classifier for a round, either in the sense of a round of ammunition, a round of a competition or a round of meetings.	
ตารางสอน	dtaa-raang sŏn	classroom time table, subject time table, time schedule	
เมล็ด	má-lét	seed, kernel, pit	
เดา	dao	[to] guess, estimate, surmise	
เม็ด	mét	seed, grain, More Detail, เม็ด is the classifier for tablets, pills, seeds and buttons.	
มะขาม	má-kăam	tamarind	
ขนุน	kà-nŭn	jack fruit	jackfruit
นุ่น		kapok	
บาน	baan	[to] blossom, bloom, flower	[to] bloom, blossom, open out, panel, frame, excessively
ร่ม (เงา)	rôm ngao	[to] shade, protect	
ปลู่อย		[to] release, let go, set free	
สักครู่	sàk krôo	for a while	for a moment, a moment
แนว	naew	style, trend, fashion, way, route, row	
ถนน	tà-nŏn	road, street, avenue	
กระถาง	grà-tăang	pot, pitcher, vessel	
ริม	rim	base, beside, pedestal	foot, base, pedestal
เพาะ	pór	[to] cultivate, plant, grow	
เก็บ	gèp	[to] keep, store, maintain, [to] collect, gather	
ยางลบ	yaang lóp	earaser	eraser
ไม้บรรทัด	mái ban-tát	ruler, straightedge	
ตะขาบ	dtà-kàap	centipede	
ปุ๋ย	bpŭi	soundly, fertilizer, manure, compost	
หา	hăa	find, search	[to] search for, look for, otherwise, no, not, [to] meet, visit, [to] accuse, blame
คลุม	klum	cover, put on top	[to] cover, spread over, vaguely, ambiguously, indistinctly
ซอก	sôk	nook, corner, niche	
เล็บ	lép	nail, claw, talon	
ประเทศ	bprà-tâyt	country, state	country, nation, state
พืช	pêut	vegetation, plant	
ตลอดปี	dtà-lòt bpee	all year	all the year, throughout the year
ออกพรรษา	òk pan-săa	"Ok Phansa, More Detail, the date marking the end of the Phansa rainy season, also known as ""Buddhist lent"""	
ตกลง	dtòk long	[to] fall down, OK, okay then, sure, [to] be OK, agree	
ลอยกระทง	loi grà-tong	Loy Kratong	
จัดงาน	jàt ngaan	[to] arrange, organize	
แข่ง	kàeng	[to] race, compete	
เรือยาว		long boat	
เรืือแจว	reua jaew	paddling boat	
แพ	pae	raft	
รอง	rong	[to] support, prop up, back up,	[to] carry, bear, support [the weight], Vice-, Deputy-, [to be] subordinate, second
ใบตอง	bai dtong	banan leaf	
เย็บ	yép	[to] sew	
วิธี	wí-tee	means, way, method	
เหลา	lăo	[to] sharpen, hone, whet	
ไม้กลัด	mái glàt	small bamboo pin	
เตือน	dteuan	to] remind, warn, advise	
แทง	taeng	[to] stab, pierce, knife, [to] note down, write down	
กาบกล้วย	gàap glûay	spathe, bract	leaf sheaf
คล้าย	kláai	[to] resemble, similar, alike	
ปัก	bpàk	[to] stick, plunge down, stab down, [to] embroider	
นม	nom	milk, breasts, chest, It's used just to provide a 'rhyming' counterpart to นาน	
พาย	paai	[to] row, paddle, scull, paddle, oar, pie	
ระลอก	rá-lôk	ripple, small wave	
โคลงเคลง	klohng kay long	[to] roll, sway, shake	[to] toss, rock, sway
เอียง	iang	[to be] tilted, inclined, [to] tilt, incline	
ล่ม	lôm	[to] collapse, fail, go down	
กู้	gôo	[to] salvage	[to] borrow, raise a loan, take on loan, [to] retrieve, redeem, save
สามารถ	săa-mâat	can, be able to	
พร้อม	próm	at the same time, simultaneously, together, with, together with, [to be] ready, prepared, set	
นกหวีด	nók wèet	whistle	
โยก	yôhk	[to] sway, shake (back and forth or side to side)	
จัังหวะ	jang-wà	rhythm, beat (of music)	
แห่	hàe	to] march, parade, demonstrate	parade, procession, array, [to] flock, throng, crowd
รวม	ruam	[to] combine, add up, include	
ท่าน้ำ	tâa náam	waterside	
คว่ำ	kwâm	to] turn over, capsize	[to be] upside-down, [to] turn-over, overturn, turn inside-out
จม	jom	to] sink, submerge	
เสียดาย	sĭa daai	[to be] regrettable, [to] regret, feel sorry, More Detail, for missing, wasting or not making the most of something	
นาน	naan	long, for a long time	
เดือนธันวาคม	deuan tan-waa kom	December	
ใต้ถุน	dtâi	under, beneath, below	
ทำนา	tam naa	[to] farm	
ยาย	yaai	grandmother, grandma, grandmamma	
แว่นตา	wâen dtaa	glasses, spectacles	
อายุ	aa-yú	age	
หลุด	lùt	[to] slip out, fall off, become detached	
เคี้ยว	kíeow	[to] chew, grind, masticate	
เหงือก	ngèuak	gum, gill	
กลืน	gleun	[to] swallow, gulp down, devour, [to] blend, be harmonious	
อ่อน	òn	[to be] weak, feeble, submissive, [to be] tender, soft, [to be] young, immature, inexperienced	
ถอน	tŏn	[to] withdraw, pull out	
น้อง	nóng	(younger) brother, sister	brother, sister, friend, relative, colleague, I, you, he, she, him, her
ไกว	gwai	[to] rock, swing, sway	
เปล	bplay	hammock, cradle	
ผ้าเช็ดตัว	pâa chét dtua	towel, bath towel	
ผ้้าห่ม	hòm	blanket	
ไหล่	lài	shoulder	
อก	òk	breast, chest, soul	
อบอุ่น	òp ùn	[to be] warm, genial, friendly	
ใบหน้า	bai nâa	face	
จมูก	jà-mòok	nose	
คิ้ว	kíw	eyebrow, brow, ridge, molding, edging	
ลำตัว	lam dtua	torso, trunk, body	
แขน	kăen	arm, limb	
นุ่มนิ่ม	nûm nîm	soft	[to be] bland, graceful
เรื่อย ๆ	rêuay rêuay	continue	continuously, slowly, unhurriedly
สะดุด	sà-dùt	[to] stumble, [to] discontinue, cease, stop	
ปัด	bpàt	to] push away, brush away, sweep off	
ฝุ่น	fùn	dust, powder	
แข้ง	kâeng	shin	
เมื่อย	mêuay	[to] feel stiff, have an ache	
หนัก	nàk	severely, harshly, [to be] heavy, hard, [to be] serious, severe	
เช้าตรู่	cháo dtròo	early morning	dawn, daybreak, sunrise
งอบ		book-4 farmer hat	
แบ่ง	bàeng	[to] share, divide out, portion out	
ส่วน	sùan	some part, certain part	as for, for, part, portion, component
เก็บ	gèp	[to] store, reserve, keep	[to] keep, store, maintain, [to] collect, gather
เหลือ	lĕua	remainder, excess	[to] remain, leave, left off, [to be] excessive, surplus, more than necessary
ทำไร่	tam râi	[to] farm, do farming, do crop-farming	
ทำสวน	tam sŭan	[to] garden, grow tree crops, plant	
ข้าวโพด	kâao-pôht-kûa	sweet corn	
แตงกวา		cucumber	
รายได้	raai dâi	income, salary	
ร่างกาย	râang gaai	body	
แข็งแรง	kăeng raeng	[to be] strong, healthy	
ออกกำลังกาย	òk gam-lang gaai	[to] exercise, work out	
ควาย	kwaai	buffalo	
รถไถนา	rót tăi naa	trackter	tractor
หว่าน	wàan	[to] sow, scatter	
เดือนสิงหาคม	deuan sĭng-hăa kom	August	
เดืือนกันยายน	deuan gan-yaa-yon	September	
เดือนตุลาคม	deuan dtù-laa kom	October	
หล่อเลี้ยง	lòr líang	[to] provide nourishment, nourish, feed	
รวง	ruang	ear of rice, ear of paddy	ear of paddy, ear of grain
เหลืือง	lĕuang	yellow	
เคียว	kieow	hook	sickle, scythe
เก็ี่ยว		[to] harvest, reap, mow	
ผึ่ง	pèung	[to] sunbathe	dry, expose
มัด	mát	[to] bind, tie, fasten	
ฟ่อน	fôn	bundle, sheaf, sheaf	
นวด	nûat	to] thresh, thresh rice	[to] massage, knead, stroke
ขาด	kàat	[to] break off, break up, sever	[to] lack, need, miss, completely, absolutely, [to be] lacking, [to be] broken, separated, torn, [to be] final
เอื้อเฟื้อ	êua féua	[to] help each other, aid	[to be] generous, kind, helpful
รวย	ruay	[to be] rich, wealthy	
ได้ผล	dâai pŏn	[to] work well, get a good result	[to] be effective, work
อด	òt	[to] refrain, go without, miss out on	
เดือน มกราคม	deuan mók-gà-raa kom	January	
ญาติ	yâat	relatives, relations, folks	
ทัน	tan	[to be] on time, up-to-date, in time, on time	
พิธี	pí-tee	ceremony, ritual	
ทัักทาย	ták taai	[to] greet, say hello, address	
ประนมมือ	bprà-nom meu	raise both hands up palm against palm	[to] pay obeisance
ลูกสาว	lôok săao	daughter	
พิี่สาว	pêe săao	(older) sister	
แนะนำ	náe nam	[to] introduce, [to] advise, recommend	
พี่เขย	pêe kŏie	brother-in-law	
นามสกุล	naam sà-gun	surname, family name, last name	
นางสาว	naang săao	miss, Ms.	
นาง	naang	woman, lady, Mrs, she, her	
แก้ว	gâew	glass, cup, crystal	
กระโถน	grà-tŏhn	spittoon, cuspidor, chamber pot	
น้ำชา	náam chaa	tea	
พาน	paan	tray with pedesta	[to] encounter, meet
ทำครัว	tam krua	[to] cook	
ตำ	dtam	[to] pound, pestle, [to] sting, stab, prick	
ผัด	pàt	[to] powder, [to] fry, [to] postpone, delay, put off	
ทอด	tôt	[to] deep fry	[to be] deep fried, [to] extend, stretch out, cast out, [to] fry
แมลงวัน	má-laeng wan	fly, housefly	
ตอม	dtom	[to] swarm, fly around, crowd	
ปอก	bpòk	[to] peel, pare, shell	
หอม	hŏm	onion	"[to be] pleasant-smelling, sweet-smelling, [to] kiss, ""sniff kiss"", More Detail, A ""sniff kiss"" is a traditional Thai way of showing affection to a loved one, and involves putting your nose to someone's cheek and gently inhaling. It's regarded as as more discrete and more acceptable in public than a western style kiss (จูบ)."
กระเทียม	grà-tiam	garlic	
ลากิจ	laa	leave duty, work, business	
พลศึกษา	pá-lá-sèuk-săa	physical education	
หัด	hàt	[to] practice, train, drill, measles	
กายบริหาร	gaai bor-rí-hăan	exercise, physical exercises	
กีฬา	gee-laa	sport, game, exercise	
โทษ	tôht	[to] blame, accuse, punishment, penalty	
เปิด	bpèrt	[to] open, turn on, switch on	
แกะ	gàe	[to] unwrap, unpack, unbind, sheep, ewe, ram, [to] engrave, etch, carve	
บุรุษไปรษณีย์	bù-rùt bprai-sà-nee	postman	
โง่	ngôh	[to] be foolish, be stupid, be silly	
เจริญ	jà-rern	[to] recite a prayer, chant, pray, [to] prosper, grow, develop	
กระดูกสันหลัง	grà-dòok săn lăng	backbone, spine, vertebral column	
เป็ด	bpèt	duck	
ในประเทศ	nai bprà-tâyt	domestic, local, in the country	
ต่างประเทศ	dtàang bprà-tâyt	abroad, foreign country	
ค้าขาย	káa kăai	[to] trade, buy and sell, do business	
หนักแน่น	nàk nâen	surely, fixedly, readily, [to be] firm, stable, resolute	
ทหาร	tá-hăan	military, soldier	
เครื่องแบบ	krêuang bàep	uniform	
หมวก	mùak	hat	
เหล็ก	lèk	iron, steel	
ป้องกัน	bpông gan	[to] protect, defend, prevent	
มุ่งหมาย	mûng măai	[to] aim at, intend, mean	
รบกวน	róp guan	[to] annoy, bother	
เดือดร้อน	dèuat rón	[to] be in trouble, be distressed, be vexed	
เท่าเทียม	tâo tiam	[to] be equal, be equivalent, be on a level with	
เสี่ยง	sìang	[to] risk, gamble, piece (of), fragment, portion	
สละ	sà-là	[to] sacrifice, make a sacrifice	[to] abandon, discard, renounce
รอด	rôt	[to] survive, escape from death, save	
ทำท่า	tam tâa	seem, look like, [to] act, conduct oneself	
ควัก	kwák	[to] scoop out, dig out, gouge	
ปืน	bpeun	gun, firearm, rifle	
ยิง	ying	[to] shoot, fire	
ขำ	kăm	[to] laugh, giggle, [to be] attractive, charming	
แพะ	páe	goat	
บำรุง	bam-rung	[to] care for, nourish, maintain	
พระเจ้าแผ่นดิน	prá jâo pàen din	King	king, monarch, sovereign
เคารพ	kao-róp	[to] respect, esteem, regard	
ผูกพัน	pòok pan	relationship, connection	[to] have one's heart
มิ่งขวัญ	mîng kwăn	idol	
สามัคคี	săa-mák-kee	harmony, congruity, [to] unite, be in harmony, be in unity	
ถิ่น	tìn	area, region, part	
แหลมทอง	lăem tong	Southeast Asian Peninsula, Golden Peninsula	
แผ่นดิน	pàen din	land, territory, country	
กษัตริย์	gà-sàt	King	king, monarch
ศาสน์		religion	
เคาะ	kór	[to] rap, strike, knock	
เพื่อน	pêuan	friend, mate, pal	
จบ	jòp	the end	[to] end, finish, come to an end
ปรบมือ	bpròp meu	[to] clap, applaud	
เดือน มีนาคม	deuan mee-naa kom	March	
ในหลวง	nai lŭang	King	king
พระราชินี	prá raa-chí-nee	Queen	queen, empress
เยี่ยม	yîam	[to] visit, go to see, call on, [to be] excellent, superb, outstanding	
พระราชทาน	prá râat taan plerng sòp	Give	
ยากจน	yâak jon	[to be] poor, impoverished, broke	
ตรัส	dtràt	said	[to] say, speak, talk
รับเสด็จ	ráp sà-dèt	[to] welcome, greet, receive	
แถวหน้า	tăew nâa	first row	front row
ถวาย	tà-wăai	[to] offer, dedicate, present	
ดอกกุหลาบ	dòk gù-làap	Rose	rose
เหยียบ	yìap	tread, tramping, stamping	almost, nearly, [to] tread (on), step on, trample
สุขภาพ	sùk-kà-pâap	health, wellbeing, good condition	
เจ้าฟ้า	jâo fáa	prince, His Royal Highness	
เมตตา	mâyt-dtaa	kindness, compassion, mercy	
ปราณี	bpraa-nee	kindliness, compassion, pity	living things, creature, human
ห่วงใย	hùang yai	[to be] care about, be concerned about	
เยี่ี่ยม	yom	visit	
ราษฏร	râat-sà-dton	commoner	
ช่วยเหลือ	chûay lĕua	[to] help, aid, assist	
ทั่วแดน	tûa	all over, everywhere in	
ภูมิใจ	poom jai	[to] be proud (of)	
ภาษา	paa-săa	language	
การอ่าน	gaan àan	reading	
การเขียน	gaan kĭan	writing	
ตัวสะกด	dtua sà-gòt	final consonant	
ข้อกำหนด	kôr gam-nòt	regulation, rule, condition	
ศึกษา	sèuk-săa	[to] study, learn	
เมินเฉย	mern chŏie	[to] pay no attention to, ignore	
ซ้ำ	sám	repeatedly, [to] repeat, [to be] repeated, recurrent	
ควบกล้ำ	kûap glâm	diphthong	
จดจำ	jòt jam	remember, memorize	[to] remember, bear in mind, keep in mind
ใส่ใจ	sài jai	[to] pay attention to, attend	
ฝึกพูด	fèuk	to speak	
ฝึึกเขียน	fèuk	to write	
กรอก	gròk	[V] to fill, fill out, fill in [VT] to pour (into something), fill up	[to] fill in, fill out, complete
กระจาด	grà-jàat	[NC - ใบ, ลูก] a woven bamboo basket	basket, wicker basket
กระจาย	grà-jaai	[V] to disperse, broadcast, spread, scatter	[to] spread, expand, extend
กระฉับกระเฉง	grà-chàp-grà-chăyng	[SV] to be active, energetic, vigorous, brisk, exuberant	[to be] vigorous, energetic, active
กระเด็น	grà-den	[V] to bounce off, throw off, (water) splash, rebound	[to] bounce off, rebound, throw off
กระติก	grà-dtìk	[NC - ใบ, ลูก] canteen, water bottle	water canteen, water bottle, canteen
กระทั่ง	grà-tâng	[Prep] until, to [Conj] even so, go so far as [V] to crash, collide, hit	until, through, till, as far as
กระแทก	grà-tâek	[V] to crash against, bump, hit, (of a door) slam	[to] hit, bump, crash against
ก้อนกรวด	gôn grùat	[NC - เม็ด, ก้อน] gravel, pebble, small stone	pebble, grit, gravel
ก่อไฟ	gòr fai	[V] to light a fire, kindle	[to] light, start a fire, kindle a fire
กันแดด	gan dàet	[SV] to be sunproof, sunblock	
กันเถอะ	gan tùh	[Phrase] (usage : V + กันเถอะ) let's do V together	let's, let us
เกรง	grayng	[SV] to be afraid, be in awe, respectful of, fearful	[to] fear, be afraid of, be in awe of
เกลือกกลั้ว	glèuak glûa	[V] to associate with, fool around with	[to] associate with, roll over, fool around
เกสร	gay-sŏn	[N] pollen	
โกรธ	gròht	[SV] to be angry (with), mad (at)	
ไก่ขัน	ไก่-ขัน	[N] cock's crow	
ขณะนั้น	kà-nà nán	[Adv] (phrase) at that time, at that moment, just then	
ขัดใจ	kàt jai	[V] to offend, displease	[to] offend, dissatisfy, displease
ข้างล่าง	kâang lâang	[SV] to be below, underneath [N] downstairs	downstairs, below, beneath, under
เข้าใจผิด	kâo jai pìt	[V] to misunderstand	[to] misunderstand, mistake
ครั้น	krán	[Conj] when (something occurs), if, since	when, at the time
คราด	krâat	[NC - อัน] (garden tool) rake	[to] harrow, harrow, rake, curry-comb
คราวก่อน	kraao gòn	[N] last time, previous time [Adv] previously	last time, previous occasion, previously, on the previous occasion
ครึ่ง	krêung	[SV] to be mid-way, half	
ควันไฟ	kwan fai	[N] smoke	smoke, fume
คว้า	kwáa	[V] to win, gain [V] to grab hold of, snatch at, grasp for	[to] seize, grab, grasp
เครื่องมือ	krêuang meu	[NC - เครื่อง] (lit. hand tool) tool, instrument, apparatus [N] (comp., menu) tools	
แคร่	krâe	[N] litter, stretcher [N] (of a typewriter) carriage	
งอบ	งอบ	[NC - ใบ, ลูก] (made of bamboo or palm leaves shaped on inverted bowl) farmer's hat	
จำไว้	jam wái	[V] (for the future) to remember, bear in mind	[to] remember, bear in mind, keep in mind
เฉือน	chĕuan	[V] to cut, arve. slice	[to] win, overcome, [to] slice, cut, carve
ชายทุ่ง	chaai tûng	[N] (of a field), edge, boundry	edge of field, boundary of field
เชื่อถือ	chêua tĕu	[V] to trust, believe in, have fath in, rely on, respect	[to] trust, have faith in, rely on
ดอกบัว	dòk bua	[N] lotus, water lily	
เดินเล่น	dern lâyn	[V] to walk, stroll	[to] stroll, promenade, take a walk
ตะโกน	dtà-gohn	[V] to shout, yell out, cry out	[to] shout, shout out, call out
ตัวเอง	dtua ayng	[Pron] yourself, oneself, alone	oneself, ourselves
ตามปรกติ	dtaam bpròk-gà-dtì	[Adv] normally, ordinarily, usually	usually, ordinarily, normally
ตื่นขึ้น	dtèun kêun	[V] to wake up, be awake	[to] wake up, be awake
ทอแสง	tor săeng	[V] to shine	[to] shine
นี่แหละ	nêe làe	[Pron] this, these	That's it, !, this, this one, these
บริเวณ	bor-rí-wayn	[N] area, sector, precinct, vacinity	area, zone, region
บาดแผล	bàat plăe	[NC - แห่ง, ที่] cut, wound, injury	wound, cut, injury
เบ้	bây	[V] to twist, distort, make a wry face	[to] pull a wry face, [to] twist, distort, contort
ประจบ	bprà-jòp	[V] to flatter, curry favor	[to] flatter, fawn
ประแป้ง	bprà-bpâeng	[V] to powder	[to] powder
ปราด	bpràat	[V] to rush, hasten [Adv] quickly, swiftly	swiftly, quickly, speedily, [to] rush, dash, hasten
ปลุก	bplùk	[V] to wake up (someone), excite	[to] rouse, awaken, evoke
เป็นประจำ	bpen bprà-jam	[Adv] routinely, regularly, frequently, often, always	regularly, frequently, normally
เปลี่ยนใจ	bplìan jai	[V] to change one's mind	[to] change one's mind, back-pedal, back out
เปียกโชก	bpìak chôhk	[SV] to be soaked, completely wet	[to] soak, saturate, drench
โผล่	plòh	[V] to begin to show, emerge, become slightly visible, appear, show up	[to] emerge, appear
ฝูง	fŏong	[N] flock (of birds), herd, pack, crowd, (of fish) school, (of bees) swarm [Cl] (for herds or other groups of animals)	group, crowd, mass
พระอาทิตย์	prá aa-tít	[N] the sun	
พัดผ่าน	pát pàan	[V] to blow	[to] blow
พื้นดิน	péun din	[N] soil, earth	ground, land, surface
พูดจา	pôot-jaa	[V] (colloq.) to speak, talk, confer	[to] speak, confer
พูดปด	pôot bpòt	[V] to tell a lie	[to] lie, tell a lie
มะปราง	má-bpraang	[NC - ลูก] (a 1 inch to 2 inch sweet to slightly sour fruit in the cashew or sumac family which is yellow / orange at maturity) Marian plum, plum mango	marian plum
มะยม	มะ-ยม	[NC - ลูก, ต้น] country gooseberry	
ไม่ขาดระยะ	mâi kàat rá-yá	[Adv] continuously, ceaselessly, endlessly	continuously, endlessly, unbrokenly
ไม่เคย	mâi koie	[VAux] has never, never did	
ร้องเรียก	róng rîak	[V] (using the voice) to call out	[to] call
รำคาญ	ram-kaan	[SV] to be annoyed, irritated, disturbed	[to] feel annoyed, feel bored
เรื่อ	rêua	[SV] to be pale, faint	pale, light, faint
เรือง	reuang	[SV] to be shining, bright, glowing	[to be] shining, glowing, bright
ลั่น	lân	[V] to burst out, explode, pull the trigger [SV] to be loud, racious	[to] rumble loudly, loudly, in a high voice, noisily, [to] shoot, fire, pull the trigger
ล้างหน้า	láang nâa	[V] to wash one's face	[to] wash one's face
สระผม	sà pŏm	[V] to wash one’s hair, shampoo	[to] shampoo, wash
สะบัด	sà-bàt	[V] to fling, (of a body part) flip, (of a rug) shake, shake off	[to] flick, flip, [to] shake off, fling, get away from
สัญญา	săn-yaa	[NC - ข้อ, ฉบับ] legal contract, agreement, promise, treaty	contract, agreement, promise, [to] promise, vow
สำราญใจ	săm-raan jai	[SV] to be happy, contented	[to] content, be happy, appease
สีทอง	sĕe tong	[N] the color gold	[to be] gold
หน้าตื่น	nâa dtèun	[V] (of looks) startled, puzzled	[to] look startled, look puzzled
หมาป่า	măa bpàa	[NC - ตัว] wolf	
หมู่	mòo	[Cl] (for group, collection, herd, flock, party, crowd) [Adv] at the present time, recently, lately [NC - หมู่] group, flock, squad, class, genus, collection, neighborhood	
หยวก	yùak	[NC - ท่อน, ต้น] banana stlak	banana stalk
หรือยัง	rĕu yang	[Conj] (formal) or not, if, whether	or not yet
หลอก	lòk	[V] to trick, deceive, (on a test) cheat [V] to scare, frighten [SV] to be fake, false	[to] deceive, trick, cheat
หลอกลวง	lòk luang	[V] to trick, fool, decieve	
หั่น	hàn	[V] to slice, cut into pieces [V] (sports) to defeat	[to] cut, slice
หากิน	hăa gin	[V] (lit to search for food) to make a living	[to] make a living, earn a living
เหงา	ngăo	[SV] to be lonely	[to be] lonely
เหงื่อ	ngèua	[N] sweat, persipiration	sweat, perspiration
เหลวไหล	lĕo lăi	[SV] to be nonsensical, ridiculous, foolish, absurd, silly	[to be] nonsensical, ridiculous
เอะอะ	è-à	[SV] to be noisy, boisterous, loud	boisterous, tumultuous, noisy, boisterously, noisily, loudly
กลับกัน	glàp gan	[V] to go back with, reverse, invert [SV] to be reverse, inverse	[to] reverse, invert
การเกษตร	gaan gà-sàyt	[N] farming, agriculture	
กิ่ง	gìng	[N] branch, twig, limb [Cl] (for branches, pieces of ivory)	branch, twig, bough
ขบวนแห่	kà-buan hàe	[NC - ขบวน] procession, parade	procession, parade, cortege
ขย่ม	ขะ-หย่ม	[V] to jump up and down, push down repeatedly [V] to wrap up [V] to make worse, to cause deterioration	
ขยับ	kà-yàp	[V] to move (a little), change position	[to] move (oneself), shift
ขออนุญาต	kŏr à-nú-yâat	[V] to ask persmission (to do something), Can I ..., May I ...	[to] ask for permission
เขย่า	kà-yào	[V] to shake, swing, give something a hard shake	[to] shake, rock, vibrate
คึกคะนอง	kéuk ká-nong	[SV] to be in high spirit, impetuous [Adv] wildly, impetuously	impetuously, wildly, [to be] impetuous, high-spirited
คุณ	kun	[Pron] you [Pron] (colloq., respectful title usually followed by a name) Mr., Mrs., Ms. [N] virtue, value, benefit, merit, goodness, prosperity	"you, Mr, Mrs, Miss, Ms, kindness, virtude, benefit, More Detail, คุณ, usually transliterated as ""Khun"", is a standard polite and relatively formal title used before the names of both men and women in Thai. Unlike the English equivalent titles though, ""Khun"" is always used before first names and not surnames. This is a practice many Thais carry over when talking in English, so in Thailand John Smith would frequently be called Mr John (Khun John) rather than Mr Smith. This habit leaves the English of many Thais sounding somewhat more informal than they intended."
งานฉลอง	ngaan chà-lŏng	[NC - งาน, ครั้ง] festival, celebration	celebration, festivity, festival
จอม	jom	[N] leader, chief, head man [Na] (Thai boys nickname)	top, highest point, peak
ฉวัดเฉวียน	chà-wàt-chà-wĭan	[V] (of a bird, plane, parade) to circle, hover, wheel around, drive in circles [Adv] circuitously	[to] circle, hover, wheel
โชคดี	chôhk dee	[Phrase] good luck, good fortune	good luck!, take care!, [to be] lucky, fortunate
เซ	say	[V] (walk unsteadly) to stagger	[to] stagger
โดน	dohn	[VAux] (indicating the passive voice) [V] to collide, strike, hit, bump against	[to] be in trouble, get in trouble, [to] hit, strike, collide against, It's an auxiliary that indicates the following verb is in the passive voice
ตลก	dtà-lòk	[SV] to be funny [V] to joke, be a comedian	[to be] funny, comical, amusing
ถนัด	tà-nàt	[SV] to be skilled, clever, handy [Adv] cleverly, skillfully [Na] (common Thai given name) Thanat	[to] be skilled (at), be adept (at), [to] be convenient, be comfortable
ถลก	tà-lòk	[V] to roll up, pull up, skin, strip	[to] roll up, pull up, hitch up
ถลอก	tà-lòk	[SV] to be scraped, scratched	[to be] scratched, bruised
ถี่ยิบ	tèe yíp	[Adv] quickly, rapidly, swiftly	quickly, rapidly, speedily
เถอะนะ	tùh	[Part] (insistance) let's (followed by the softening นะ)	
ทยอย	tá-yoi	[Adv] one by one, one after another, in succession [V] to follow one another	[to] follow one after another, one by one, in succession, one after another
นาค	nâak	[Na] (mythological snake of Hindu origin found on nearly every wat in Thai) Naga [NC - คน] (person entering the Buddhist priesthood) nak [Na] (Thai given name or nickname meaning 'fabulous serpent') Nak	Naga, More Detail, a mythological serpant in Hindu and Buddhist mythology
ปฏิเสธ	bpà-dtì-sàyt	[V] to refuse, deny	[to] deny, refuse, refute
ปรอท	bpà-ròt	[N] (Pali loan word, element) mecury, Hg [N] temperature, thermometer	mercury, hydrargyrum, quicksilver
ป่านนี้	bpàan née	[Adv] at this time, even now, by now, until now, thus far	even now, thus far, by now
ปุ๋ย	bpŭi	[N] (Chinese loan word) fertilizer, manure [Adv] soundly, deeply [Na] (common Thai female nickname) Pui	soundly, fertilizer, manure, compost
ปุ๋ยคอก	bpŭi kôk	[N] (from a coop or sty) manure	manure, stable manure, farmyard manure
เป็นมั่นเหมาะ	bpen mân mòr	[Adv] surely, certainly, definitely, absolutely, readily	surely, fixedly, readily
เปล่า	bplào	[SV] to be empty, blank [Adv] no, not	no, not, [to be] empty, blank, vacant
ไปไหนมา	bpai năi maa năi	[Q] Where have you been?	
ผสม	pà-sŏm	[V] combine, mix, blend	[to] mix, blend, mingle
เผอิญ	pà-ern	[Adv] accidentlally	by chance, be accident, accidentally
ฝรั่ง	fà-ràng	[N] Westerner (Caucasian) [N] guava	"Western, Westerner, Caucasian, ""farang"""
พนมมือ	pá-nom meu	[V] (formal, as greeting sign of respect) to put one's hands together, wai	[to] phanom, More Detail, putting the hands together in front of your chest as a salute
พนักงาน	pá-nák ngaan	[N] employee, officer, person in charge	official, staff, employee
พยักหน้า	pá-yák nâa	[V] (in assent or agreement) to nod	[to] nod, nod in assent
พยาธิ	pá-yaa-tí	[NC - ตัว] parasite, worm [N] (technical) ailment, malady	
พยุง	pá-yung	[VT] to prop up, sustain, support	[to] support, help, assist
พวง	puang	[Cl] (for clusters of things or wreath shaped objects such as steering wheels, cluster of grapes, flower wreaths, etc.) [N] string, cluster, bunch	
มีธุระ	mee tú-rá	[SV] to be busy, occupied	[to] be busy, have an errand, be engaged
ยังกับ	yang gàp	[Conj] like, as if, as though	as if, like, as, as though
รอยถลอก	รอย-ถะ-หฺลอก	[NC - รอย] (on the skin or body) scratch	
ระหว่างทาง	rá-wàang taang	[Adv] along the way, on the way	on the way, along the way
รางวัล	raang-wan	[NC - รางวัล] prize, reward, award [Cl] (for awards, prizes)	prize, award, trophy
เร่ง	râyng	[V] (of speed) to hurry, urge, urge on [V] (of exams) to cram for	[to] hasten, hurry, rush
เร็วขึ้น	reo	[V] to speed up	
ลงนอน	long non	[V] to lie down	[to] lie down
ลิงแสม	ling sà-măe	[NC - ตัว] crab-eating monkey	crab-eating macaque
ลื่นไถล	lêun tà-lăi	[V] (lit. to lose one's task) to interrupt, lose focus	[to] slip, slide, skid
ลูกสมุน	lôok sà-mŭn	[NC - คน] (negative connotation) flunky, underling, stooge, attendant, follower	henchman, underling, minion
โล่งอก	lôhng òk	[V] to feel relief, be releived	[to] be relieved, feel relieved, relievedly, without worry or anxiety
ว่องไว	wông-wai	[SV] to be quick, agile, nimble [Adv] qucikly, nimbly	[to] be agile, be quick, be nimble, quickly, agilely, nimbly
สงบเสงี่ยม	sà-ngòp sà-ngìam	[SV] to be modest, quiet, reserved, mild	[to] be modest, be reserved, be mild
สง่า	sà-ngàa	[SV] to be majestic, diginified	[to be] majestic, dignified
สนับสนุน	sà-nàp-sà-nŭn	[V] to sponsor, help, support	[to] support, aid, give support to
สมัครใจ	sà-màk jai	[V] to be willing (to do something), volunteer	be willing to, volunteer, like volunteer
สรุป	sà-rùp	[V] to sum up, summarize	concisely, briefly, in brief, [to] sum up, conclude
สลด	sà-lòt	[VI] to become sad, grieve [V] (of flowers) to wither, wilt [SV] to be sad, depressed, meleancholy	[to] wither, [to] feel sad, feel depressed, be melancholy
สหกรณ์	sà-hà-gon	[NC - แห่ง] co-operative, co-op	
สัก	sàk	[Adv] just, approximately, at least [N] (general term) teak [V] to tattoo	just, about, around, teak, teak tree, [to] tattoo
เสียงาน	sĭa ngaan	[V] (lit. to lose one's task) to interrupt, waste effort, lose focus	[to] lose one's task
หน้าซีด	nâa sêet	[V] (as in facial color) to become pale	[to] pale
หน้าบาน	nâa baan	[V] to delight, be a pleasure	[to] delight, be pleasure
หนาม	năam	[NC - อัน] thorn, barb, prickle, burr, spine	thorn, prickle, barb
หยด	yòt	[N] (of liquid) a drop [V] to drip [Cl] (for drops of liquid)	[to] drop
หล่น	lòn	[V] to drop, fall	[to] fall, drop
หลบ	lòp	[V] to avoid, dodge, duck	[to] avoid, evade, duck
เหยียดยาว	yìat yaao	[V] to stretch out, sprawl	[to be] stretching
เหลือบ	lèuap	[V] to glance sideways, look aside [NC - ตัว] horse fly, cattle fly	[to] glance at, glimpse, peek, horsefly, gadfly
แหงน	ngăen	[V] to look up, turn one's face upward	[to] turn up, look up
แหละ	làe	[Part] (colloq.) (emphasizes what comes before)	"It's a particle giving a sense of ""this/that very one exactly this/that one this/that one in particular """
องุ่น	à-ngùn	[NC - พวง, ผล, ลูก] grape	
อย่างเดิม	yàang derm	[Adv] as usual, like always	as it was, as before, as previously
อย่างสนิทสนม	yàang sà-nìt sà-nŏm	[Adv] nformally, friendly, intimately, cordially	
อย่างสบายใจ	yàang sà-baai jai	[Adv] happily, contentedly	happily, contentedly, satisfyingly
เอกเขนก	àyk kà-nàyk	(with an elbow on a pillow or the floor) to recline, lean back	reclining, comfortably, [to] recline
เออ	er	[Intj] (impolite excalmation of agreement used only with close friends) Yeah	yeah, yes, More Detail, As it's relatively impolite, เออ is generally used among close friends only.
กรรม	gam	[N] (formal, when refering to karma this word has a bad connotation ) deed, karma, sin, destiny [N] action, act [NC - คำ] (Thai gramar) object of a verb	"sin, wrong-doing, transgression, deed, action, performance, bad karma, More Detail, กรรม when referring to karma is always used in a negative sense its opposite is บุญ (""merit"")., It's a suffix to change a verb into a noun"
กระจายเสียง	grà-jaai sĭang	[V] (as in radio or TV) to broadcast, put on the air	[to] broadcast, transmit, put on the air
กรุณา	gà-rú-naa	[Adv] please (do such and such) [N] compassion, mercy [SV] to be kind, merciful	please, kindly, [to be] kind, merciful
กล่อม	glòm	[V] to calm, soothe, lull	[to] calm, soothe
กังวล	gang-won	[SV] to be anxious, concerned about, distressed	[to] worry (about), feel anxious (about)
กำจัด	gam-jàt	[V] to get rid, eliminate, eradicate, drive away	[to] eradicate, eliminate, get rid of
กำนัน	gam-nan	[NC - คน] (leader of a ตำบล, Tambon) Subdistrict chief	kamnan, More Detail, a village elder or local chief
กุศล	gù-sŏn	[N] merit, fortune, good deeds, virtue, luck	merit, good, fortune
แก้ไข	gâe kăi	[V] to correct, improve, edit [V] to fix, repair [V] to solve	[to] amend, revise, improve
โก่ง	gòhng	[V] (colloq.) to arch, bend upward, (of a price) raise [SV] to be arched, curved, bent	[to be] arched, curved, bent, [to] bend upwards, arch upwards
ขณะที่	kà-nà têe	[Phrase] at the moment when	when, while, as
ขายของ	kăai kŏng	[V] to sell merchandise, make a sale	[to] sell goods, make a sale
คนเห็นแก่ตัว	kon hĕn gàe dtua	[NC - คน] selfish person, egotist	selfish person, mean person
ครอบครอง	krôp krong	[V] to have, possess, occupy, own	[to] possess, own, belong to
คล้อย	klói	[V] to pass by, move by [V] to go along with, follow, adapt to [SV] tobe inclided to one side, slanting	[to] go along with, follow, conform, [to] pass by, move by
ความเห็นแก่ตัว	kwaam hĕn gàe dtua	[N] selfishness, exploitation, egotism, self-centeredness	selfishness, exploitation, utilization
คุณค่า	kun-kâa	[N] value, worth	worth, value
จง	jong	[VAux] [a command or order from a superior to an inferior] must, should	must, have to, should
จัก	jàk	[V] (e.g. bamboo) to split, serrate [SV] to be notched, serrated [VAux] (poetic) shall, will, would like to	will, shall
จู้ฮุกกรู	gòk	[Onom] (cooing sound make by a koei which is member of the cuukoo family) Juuhokgru	
เจตนา	jàyt-dtà-naa	[N] intention, purpose, aim [SV] to be delibertate, intentional	[to] intend, aim, mean
ใจบาป	jai bàap	[SV] to be wicked, evil, immoral, ungodly	[to be] wicked, evil, immoral
ชำนาญ	cham-naan	[SV] to be skilled, experienced, expert	skillfully, proficiently, dexterously
ชี้ให้เห็น	chée hâi hĕn	[V] to point out show, indicate	[to] indicate, point out, show
ตอนสาย	dton-săai	[N] late morning, late in the morning	
ตะวัน	dtà-wan	[N] the Sun	sun, light of day
ตัดไม้ทำลายป่า	dtàt mái tam laai bpàa	[V] to deforest	[to] deforest
ติดกับ	dtìt gàp	[Prep] next to, beside, adjacent to [V] to be next to, attached to, stuck with	adjoin, be contiguous, close to, connect
ถึงแม้	tĕung máe	[Conj] although, even though	though, although
ถือโอกาส	tĕu oh-gàat	[V] (of an opportunity) to take advantage, cash in	[to] take the opportunity, take advantage
เถิด	tèrt	[Part] [formal, placed after a verb or a sentence to indicate an exhortation, command or request) let's, let us	It's a particle adding a sense of mild urging or emphasis to the sentence
เถื่อน	tèuan	[SV] to be wild, savage, fierce [SV] (colloq.) to be bootleg, illegal, illicit, unlawful	[to be] illicit, illegal, unlawful, [to be] wild, savage, fierce
ทุกวันนี้	túk wan née	[Adv] nowadays, at present, these days	nowadays, at present, now
โทษ	tôht	[V] to blame, charge, accuse [N] sin, wickedness, evil, vice, crime, punishment, danger	[to] blame, accuse, punishment, penalty
ธรรมชาติ	tam-má-châat	[SV] to be natural [N] nature, creation	nature, natural, creation
นกกาเหว่า	nók gaa-wào	[NC - ตัว] (a parasitic nesting bird from the cuukoo family) koei	koel
นกเขา	nók kăo chá-waa	[NC - ตัว] (bird) dove [NC - อัน] (colloq., idiom) penis	
นั่นแหละ	nân làe	[Phrase] (colloq) Well then, Well there you go, Quite so	that's it, that's exactly it, that's right
นายพราน	naai praan	[NC - คน] hunter	hunter, huntsman
น่าสรรเสริญ	nâa săn-sĕrn	[SV] admirable, praiseworthy, commendable	[to be] admirable, praiseworthy
น่าอาย	nâa aai	[SV] to be embarrassing	[to be] shameful, disgraceful
นิสัย	ní-săi	[N] habit	behaviour, habits
นึกในใจ	néuk nai jai	[V] to imagine	[to] imagine
บท	bòt	[NC - บท] section, chapter of a book, school book, magazine article [Cl] (for articles in books, magzines, newspapers, for songs, poems)	chapter, lesson, part
บรรดา	ban-daa	[SV] to be all, in general, complete	all, whole, totality
บรรยาย	ban-yaai	[V] to lecture, describe, narrate	[to] describe, narrate, lecture
บาป	bàap	[NC - อัน] badness, evil, sin, demerit, vice	sin, vice, evil
บ่ายเบี่ยง	bàai bìang	[V] to avoid, evade, deviate	[to] avoid, evade, shirk
โบกมือให้	bòhk meu	[V] to wave one's hand at (something)	
ประกาศ	bprà-gàat	[V] to announce, declare, proclaim [NC - ครั้ง] announcement, poclamation, notice [N] (Christian, short for ประกาศข่าวประเสริฐ) gospel, good news	[to] announce, notify, declare
ปรากฏ	bpraa-gòt	[V] to appear, seem, become visible	[to] appear, show oneself, emerge, [to be] apparent, evident
ปัจจุบันนี้	bpàt-jù-ban née	[Adv] now, at the present time, nowadays	nowadays, at present, now
เป็นปัญหา	bpen	[Phrase] to have or to be a problem	
เป็นเรื่อง	bpen rêuang	[V] to make a mess of things, get into trouble [SV] to be something that	[to] be, become, be about, [to] get into trouble, make a mess of things
เผลอตัว	plĕr dtua	[SV] to be careless, absent-minded	[to be] careless, absent-minded
พระสุริยา	prá	[N] (poetic) sun	
พวกเขา	pûak kăo	[Pron] (3rd person plural) they, them	
พ่อคุณ	pôr	[Phrase] (poetic) good sir, my good man	
พืชผล	pêut pŏn	[N] (lit. plant - fruit) crops, produce	crops, fruits, agricultural products
ไพเราะ	pai-rór	[SV] (of sound, voice, song, music, poetry) to be melodious, pleasant, sweet	[to be] melodious, sweet, sweet-sounding, sweetly, pleasingly
ภรรยา	pan-rá-yaa	[NC - คัน] wife (formal)	
ภัยพิบัติ	pai pí-bàt	[NC - ครั้ง] disaster, catastrophe, calamity, great danger	disaster, calamity, catastrophe
มักจะ	mák jà	[VAux] will often, usually, tend to	often, frequently
มาจาก	maa jàak	[V] to come from	[to] come from, be from
เมื่อกี้นี้	mêua-gêe née	[Adv] just now, just a moment ago	just now, a moment ago, just a moment ago
ยินดี	yin dee	[SV] to be glad, happy	[to be] happy, glad
ยึด	yéut	[V] to confiscate, seize, capture, grasp, hold, cling to [V] to secure, attach, fasten [VT] to respect, have faith in, have confidence in	[to] seize, capture, grasp
รังเกียจ	rang gìat	[SV] (formal) to be bothered (by), disturbed (by), disgusted with, averse (to), against [V] to dislike, hate, strongly object	[to] dislike, hate, object to
เรือน	reuan	[NC - หลัง] (typically wooden) house, building [Cl] (for clocks, watches)	house, building, domicile
ลาย	laai	[SV] to be striped, streaked [N] pattern, design, stripes [Cl] (for signatures)	design, pattern, mark
เลว	leo	[SV] to be bad, vile, wicked	[to be] bad, evil, wicked
โลภ	lôhp	[N] greed, covetousness [SV] to be greedy, covetous	greed, avarice, cupidity
แว่ว	wâew	[V] to hear in the distance, hear vaguely [Adv] indistinctly	indistinctly, [to] hear vaguely, hear in the distance
สวรรค์	sà-wăn	[N] heaven, paradise	
สักวันหนึ่ง	sàk wan nèung	[Adv] someday	
สังเกตเห็น	săng-gàyt hĕn	[V] to notice, observe, see something happen	[to] notice, see something happen
สัตว์ป่า	sàt bpàa	[NC - ตัว] wild animal, wildlife	
สุจริต	sùt-jà-rìt	[SV] to be honest, decent, truthful, trustworthy	honest, truthful, trustworthy
เสริม	sĕrm	[V] to add, reinforce, strengthen, supplement	[to] enhance, supplement, reinforce
หนอง	nŏng	[N] pond, pool, swamp, bog [Cl] (for ponds, pools, swamps)	swamp, bog, mire, pus
หาบ	hàap	[V] to carry a load with a shoulder pole	[to] carry
เหมาะกับ	mòr gàp	[SV] to be compatible with, appropriate for	[to] be appropriate, proper, be compatible with
อาย	aai	[SV] to be shy, embarrassed	[to be] shy, embarrassed
เอื้อเฟื้อเผื่อแผ่	êua féua pèua pàe	[SV] to be considerate, helpful, generous	[to] help each other, aid
กก	gòk	[NC - ต้น] reed [V] to brood, hatch, incubate [N] base, foot, bottom	[to] brood, hatch, incubate, sedge, reed, rush, base, foot, bottom
กระโผลกกระเผลก	grà	[SV] (of walking or running) to be lame, limp	
กระหน่ำ	grà-nàm	[V] to hit, strike, attack, beat [V] to pound, batter, bang, hammer	[to] pound, hammer, thump
กะโผลกกะเผลก	gà-plòhk-gà-plàyk	[V] to limp, stumble, hobble [Adv] lamely	lamely, stumblingly, [to] hobble, limp, stumble
กำชับ	gam-cháp	[V] to reiterate, urge, repeat, insist firmly	[to] reiterate, urge, repeat
เกลา	glao	[V] to trim, (of a bush or beard) clip [V] to edit, correct, improve	[to] smooth, polish, refine
เกลี้ยง	glîang	[SV] to be smooth, even, sleek, clean [SV] to be used up, cleaned out, all gone, exhausted	[to be] smooth, flat and smooth, clean, [to be] completely used up, emptied out
เกลือก	glèuak	[V] to tumble, roll over, wallow, rub	[to] roll, wallow, welter
เกลื่อนกลาด	glèuan-glàat	[SV] to be scattered about, widely dispersed [V] to scatter, spread	[to] scattered about, widely dispersed
เกวียน	gwian	[NC - เล่ม] cart, oxcart [N] (unit of measure used for grain equal to 200 liters, an ox-cart full)	cart, bullock car
แกว่งไปแกว่งมา	gwàeng bpai gwàeng maa	[V] to swing back and forth, sway to and fro [SV] to be wiggly	[to] sway, swing, rock
ไกล่เกลี่ย	glài-glìa	[V] to reconcile, arbitrate	[to] reconcile, conciliate, arbitrate
ขยำ	ขะ-หฺยำ	[V] (with the hands) to knead, squeeze, (of paper) crumple	
ขรุขระ	krù-krà	[SV] to be rough, jagged, bumpy, uneven	[to be] rough, uneven
ขวักไขว่	kwàk kwài	[Phrase] back and forth, to and fro	back-and-forth, to-and-fro
ขว้าง	kwâang	[V] to throw, pitch, cast	[to] pitch, throw, hurl
ขวางทาง	kwăang taang	[V] to block, hinder, bar	[to] block, bar, hinder
ขวาน	kwăan	[NC - เล่ม] ax, axe, hatchet	axe, ax, hatchet
ขวิด	kwìt	[V] (like a bull) to ram, gore, butt	[to] butt, gore, horn
ขอบตา	kòp dtaa	[NC - ข้าง] (of eyes) edge, rim, socket	edge of the eyelid
เขียวชอุ่ม	kĭeow chá-ùm	[SV] (of crops) to be green, fresh, lush, grassy	[to] be verdant, be green, be fresh
คนแปลกหน้า	kon bplàek nâa	[NC - คน] stranger, newcomer	
คลั่ง	klâng	[SV] to be crazy, insane, mad, delirious	[to] madden, mad, insane, [to] be crazy about, be infatuated with
คล้ำ	klám	[SV] (of complexion) to be dark, swarthy	[to be] dark, tanned
ควาน	kwaan	[V] to grope, seach for	[to] grope, search
เคลื่อน	klêuan	[V] to move (to another place), relocate	[to] move, displace, progress
เฉียบ	chìap	[Adv] very, extremely [SV] to be outstanding, excellent, brilliant	very, exceedingly, [to be] excellent, outstanding, brilliant
ชุ่มฉ่ำ	chûm chàm	[SV] (formal) to be moist, damp, soaked, humid, luscious, refreshing	humid, moist
เชื่อม	chêuam	[V] to connect, weld, cement, solder [N] syrup [V] to stew in syrup	[to] join, connect, weld, [to] cook in syrup
ซักไซ้	sák sái	[V] to question closely, interrogate, ask, inquire	[to] interrogate, ask, question closely
ซีดเซียว	sêet sieow	[SV] (formal) to be haggard, pale, gaunt, sickly	[to be] haggard, gaunt, pale, haggardly, gauntly, palely
โดยเร็ว	doi reo	[Adv] quickly, immediately	quickly, immediately, instantly
ตกใจกลัว	dtòk jai glua	[SV] to be frighten, scared, startked, paniced	[to] be frightened, be startled, be scared
ต้องการ	dtông gaan	[V] (best usage is in a sentence which includes a clause that explains why) to need, want, request, desire, would like	[to] want, need, require
ติดยาเสพย์ติด	dtìt yaa sàyp dtìt	[SV] to be addicted to drugs	[to] be addicted to drugs
ตึ้กตั้ก	dtêuk-dtâk	[N] (sound of a throbbing heart) tick tock [Adv] loudly	
ตื่นเต้น	dtèun dtâyn	[V] to be excited, thrilled, nervous	[to] be excited, be thrilled, be nervous
เต้น	dtâyn	[V] to dance [V] to throb, beat, pulsate	[to] dance, [to] beat, throb, pulsate
ถึงตาย	tĕung dtaai	[V] to die, meet one's end	[to] meet one's death, meet one's end
ทุรนทุราย	tú-ron-tú-raai	[SV] to be fidgety, restless, uneasy	[to be] fidgety, restless
น้ำฝน	náam fŏn	[N] rain water, cistern water	rain water, rain
แน่ใจ	nâe jai	[V] to be sure, confident, certain	[to] be sure, be confident, be certain
บังคับ	bang-káp	[V] to force, command, direct, compel	[to] force, give an order, command
บิดเบี้ยว	bìt bîeow	[SV] to be twisted, distorted	[to be] twisted, distorted
บีบ	bèep	[V] to press, squeeze, squash, compel, wring out	[to] squeeze, press, compel
ประเภท	bprà-pâyt	[NC - เล่ม] type, kind, class, variety, category	type, sort, category
เป็นอันขาด	bpen an kàat	[Adv] absolutely, definitely, surely, certainly [SV] (of an item) to be forbidden, prohibited	
เป็นอันตราย	bpen an-dtà-raai	[SV] (formal) to be dangerous, harmful, evil	[to] be bad, be harmful, be hazardous
ผอมแห้ง	pŏm hâeng	[SV] to be skinny, emaciated, angular, boney, lean	[to be] very skinny, emaciated
ฝักใฝ่	fàk fài	[VI] (formal) to pay attenntion to, concentrate on, be absorbed in [VI] (formal) to support, go along with, side with, favor, be in agreement with	[to] concentrate on, pay attention to
ฝีมือ	fĕe meu	[N] manual skill, handicraft, craftsmanship	skill, ability, craftsmanship
พลาง	plaang	[Adv] (colloq.) at the same time, simultaneously	while, as, at the same time
พิจารณา	pí-jaa-rá-naa	[V] (formal) to consider, investigate, examine	[to] consider, inquire, meditate
แพลง	แพลง	[V] to sprain, twist, wrench	
มิฉะนั้น	mí chà-nán	[Abbrv] otherwise	
มือขวา	meu kwăa	[NC - ข้าง] right hand	right hand, assistant, right-hand man
มุม	mum	[NC - มุม] (of a street or room) corner [NC - มุม] angle [Cl] (for angles and corners)	angle, corner, nook
แม้แต่	máe dtàe	[Prep] even though, even	
ไม่กล้า	mâi glâa	[V] to not dare (to do something)	[to] be not brave enough, not dare
ไม่ยาก	mâi yâak	[SV] to be not hard, not difficult	easily, conveniently, smoothly, [to] be easy, be not difficult, be simple
ยาเสพย์ติด	yaa sàyp dtìt	[N] drug, narcotic	drugs, narcotics
ยู่ยี่	yêe	[SV] to be rumpled, wrinkled, untidy	
ร่วง	rûang	[V] to fall off, to drop off, shed	[to] drop, fall off, come off
ริมฝีปาก	rim fĕe bpàak	[N] (of a face) lips	
รุงรัง	rung-rang	[SV] (of hair or fur) to be messy, unkempt, shaggy, untidy, disordered	[to be] untidy, messy
รูปร่าง	rôop râang	[N] appearance, form, shape	appearance, external looks, expression
โรงสี	rohng sĕe	[NC - โรง, แห่ง] rice mill	
เลือนลาง	leuan laang	[V] to fade away, become faint [SV] to be vague, dim, indistinct	[to] fade away, faint, [to be] vague, dim, indistinct
แลเห็น	lae hĕn	[V] to catch sight of, notice, observe, see	[to] catch sight of, see, sight
ส่งให้	sòng hâi	[V] to deliver to, send to	[to] send to, transfer
สมองเสื่อม	sà-mŏng sèuam	[N] brain damage, Alzheimers disease	brain damage, brain wasting, Alzheimer
ส้มโอ	sôm oh	[NC - ผล] pomelo, grapefruit	pummelo, shaddock
สักที	sàk tee	[Adv] once, one time, even once	"It's a particle implying ""just once even once"""
สาน	săan	[V] to weave	[to] weave, entwine, intertwine
เสียงสั่น	sĭang sàn	[N] shaking sound, shivering sound	
โสน	สะ-โหฺน	[Na] (Latin name Sesbania javanica, flowering plant of the pea family whose flowers close at night and open in the early morning) sanor plant	
หนวดเครา	nùat krao	[NC - กระจุก, เส้น] beard, whisker	
เหวี่ยง	wìang	[V] to throw, cast, whirl, swing, fling	[to] throw, hurl
เอาอย่าง	ao yàang	[VT] (colloq.) to copy, imitate, assimilate	[to] imitate, follow
เอื้อมมือ	êuam meu	[VI] to reach out one's hand	[to] reach out for, stretch out one's hand for
กระบุง	grà-bung	[NC - ใบ, ลูก] bamboo wicker basket	wicker basket, bamboo basket
กั้น	gân	[V] to obstruct, block, hide	[to] separate, bar, block
กางร่ม	gaang rôm	[V] (of an umbrella) to open, raise	[to] raise an umbrella, open an umbrella
ขยาย	kà-yăai	[V] to enlarge, expand, extend, dilate, amplify, magnify	[to] expand, enlarge, extend
ขอบเขต	kòp kàyt	[NC - อัน] boundary, district, region, limit, exentent, scope, range, perimiter, domain, sphere, realm, limit	border, boundary, limit
ขอยืม	kŏr yeum	[V] to borrow	[to] borrow
ข้า	kâa	[N] servant, slave, (polite form) I, me	slave, servant, I, me
ข้าทาส	kâa tâat	[NC - คน] slave, bond servant	slave, bondwoman, bondman
ข้าวของเครื่องใช้	kâao kŏng krêuang chái	[N] untensils, instruments, appliances, implements	appliance, tool, equipment
เข้าเฝ้า	kâo fâo	[V] to have an audience with royalty	[to] appear before royolty
คงมี	kong	[V] probably has, may have	
คนตาย	kon dtaai	[NC - คน] dead person, the dead	
ความเคารพ	kwaam kao-róp	[N] (for another person) respect, esteem, regard	respect, regard, esteem
ความร้อน	kwaam rón	[N] heat, temperature, warmth	heat, hotness
คัดค้าน	kát káan	[V] to oppose, protest, object to	[to] oppose, object, disagree
ค้าง	káang	[SV] to be unfinsihed, interrupted, incomplete [SV] (colloq.) stuck [V] to owe, (of payments) to be behind	[to] owe, be due to, be behind, [to] stay overnight, spend the night, [to be] unfinished, remaining, unsettled
คาน	kaan	[V] to support, hold up [NC - คัน] (for hanging baskets) sholder pole [NC - อัน, ตัว] horizontal beam, pole	[to] counterbalance, counterpoise, beam, shaft, counterpoise
คาย	kaai	[V] (from the mouth) to spit out [SV] (of a surface) to be rough, grating [V] to emit, give off, exude, discharge	[to] spit, spit out, [to] give off, secrete, [to be] rough, coarse
คุลา	kú	[Na] (Evil woman who appears in the Thai story &#34,Pricess Soonnoi's Beautiful House) Kulaa	
เคราะห์ร้าย	krór ráai	[SV] to be unlucky, unfortunate	[to be] unlucky, unfortunate, bad luck, misfortune
เครื่อง	krêuang	[NC - เครื่อง] machine, appliance, tool, implement [NC - เครื่อง] motor, machinery, mechanical device [NC - เครื่อง] thing, article, ware, ingrediants [Cl] (for machines, mechanical items, appliances)	machine, tool, engine, More Detail, เครื่อง is the classifier for electrical appliances like TVs, computers, phones, stereos and phones.
ฆ่า	kâa	[V] to kill, murder, destroy	[to] assassinate, kill, murder, [to] cancel, cross out, delete
จัดหา	jàt hăa	[V] to get, gather, procure, provide	[to] provide, procure, obtain
จำนรรจา	jam-nan-jaa	[SV] to be talkative, chatty	[to] speak
เจ้าหญิง	jâo yĭng	[NC - องค์, พระองค์] princess	
ใจร้าย	jai ráai	[SV] to be cruel-hearted, nasty, upset, wicked [Adv] angrily	[to be] cruel, wicked, heartless
ชัย	chai	[N] victory, success, triumph	victory, triumph, win
ชาติก่อน	châat gòn	[N] previous life, former existence	
ชาวเมือง	chaao meuang	[NC - คน] towns people, city folk	city people, townspeople
ชีปะขาว	chee bpà-kăao	[NC - คน] white-robed ascetic	ascetic, white-robed ascetic
เช่นนั้น	châyn nán	[Phrase] such that	such, like that
เดินทาง	dern taang	[V] to take a trip, journey, travel	[to] travel, tour, take a trip, travel, journey
ได้ความ	dâai kwaam	[SV] to be sound, substantial [V] to learn about something, get information	[to] learn the news, get the information, know
ได้ฤกษ์	dâai rêrk	[V] (idiom) to reach an auspicious time	[to] reach the auspicious time
ได้โอกาส	dâai oh-gàat	[V] to get an opportunity, have a chance	[to] have the chance, get an opportunity
แต่ผู้เดียว	dtàe pôo dieow	[Adv] alone, by oneself, exclusively	
ไต่ถาม	dtàai tăam	[V] (formal) to ask, question, interrogate, inquire	[to] ask, inquire, question
ถอด	tòt	[V] to remove, undo, strip down, unscrew, (of clothing) to take off [V] to translate, adapt, interpret [V] (of a rank) demote, (of a command) relieve	[to] take off, remove, unscrew, [to] interpret, translate
ถอนสมอ	tŏn sà-mŏr	[VI] (of an anchor) hoist, raise, weigh	[to] hoist an anchor
ถามถึง	tăam tĕung	[V] to ask for	[to] ask for
ทรงเครื่อง	song krêuang	[V] (royal) to cut hair, be adorned, be decorated [SV] (fig. referring to having more money, things, quaility of ingrediants, etc. than is necessary) extra, over-the-top	[to] be decorated, be adorned, be appareled, [to be] over-the-top, extra, More Detail, Most commonly used to refer to having more money, more or better quality ingredients, materials etc than is necessary for what you're trying to do.
ทะเล	tá-lay	[N] sea	sea, ocean
ทางทะเล	taang tá-lay	[Adv] by sea	
ทายา	taa yaa	[V] to apply topical medicine	[to] apply topical medicine, [to be] good, important
ทาส	tâat	[NC - คน] slave	
ทำพิธี	tam pí-tee	[V] to perform a ceremony	[to] perform a ceremony
ทุกแห่ง	túk hàeng	[Adv] everywhere, every place, wherever, all over	everywhere, every place, here and there
ทูล	toon	[V] (to a royal person) to inform, report, speak with	[to] inform, report, tell
แท้	táe	[SV] to be real, pure, true, genuine	true, real, genuine
แทรก	sâek	[V] (formal) to insert, mix, add, push in, infiltrate, intervene	[to] insert
นบนอบ	nóp-nôp	[V] (press one's palms together) to respect, venerate, revere, honor, worship [SV] to be respectful	[to] respect, revere, venerate
นอนตาย	non dtaai	[V] (lit. sleep of death) to die	[to] die, become dead
น่าเกลียด	nâa glìat	[SV] to be ugly. disgusting, not look good	[to be] disgusting, unattractive, repulsive
นาง	naang	[NC - ตัว] woman	woman, lady, Mrs, she, her
นางเอก	naang àyk	[NC - คน] heroine, leading actress	main actress, leading actress
บิดา	bì-daa	[NC - คน] (formal) father	
ประพฤติ	bprà-préut	[V] to conduct oneself, behave, act, perform, do [N] manner, conduct, behavioir	[to] conduct, behave, act
ปลอบ	bplòp	[V] to console, comfort, pacify, soothe	[to] soothe, comfort, console
ปลอม	bplom	[SV] to be fake, forged, counterfeir, imitation [V] to fake, forge, conterfeit	[to be] fake, counterfeit, artificial, [to] forge, counterfeit, falsify
ปลายเดือน	bplaai deuan	[N] end of the month	
เป็นกังวล	bpen gang-won	[V] to be worried, agitated, anxious	[to] be worried, concern, be anxious
เป็นอันมาก	bpen an mâak	[Adv] greatly, considerably, enormously, tremendously	
เปรียบเทียบ	bprìap tîap	[V] to compare	[to] compare, draw a comparison between
แปลง	bplaeng	[NC - แปลง] plot of land, garden, flower bed, field [V] to modify, adjust, convert, adapt	[to] change, transform, convert, plot
ผู้รักษา	pôo rák-săa	[NC - คน] (medical) doctor	doctor, medical practitioner
ฝากซื้อ	fàak	[V] to buy (something for someone else), purchase	
พญานาค	pá-yaa-nâak	[N] great Naga, King of the Nagas, serpent	King of Nagas, serpent, great Naga
พรรษา	pan-săa	[Na] (a period of 3 lunar months during the Thai rainly season when Buddhist monks retreat to their temples and avoid unnecessary travel) Pansa	phansa, More Detail, พรรษา is a period of 3 lunar months during the rainy season when Buddhist monks retreat to their temples for ธรรม (Dharma) study and avoid any unnecessary travel. Although they may still go out to seek alms during the day, they must return to sleep in their temple and aren't permitted to defrock during พรรษา. The tradition comes from early Buddhism in India, where holy men and sages would minimise travel during the rainy season to avoid accidentally killing young animals, insects or plants. Ordinary Buddhists also do their part by pledging to give up various vices during the พรรษา period, in much the same way as Christians during Lent. Being a monk during พรรษา is thought to bring great merit, and is an act that brings pride not only to the man himself but to his entire family. Many Thai males will ordain as monks for พรรษา before getting married, although some opt to ordain for shorter periods instead. The พรรษา period is marked with 2 large nationwide festivals - เข้าพรรษา which marks the start of พรรษา and commonly falls in July, and ออกพรรษา which marks the end of it and is usually in October.
พระชนม์	prá chon	[N] (royal) age, life	
พระทัย	prá-tai	[N] (royal) heart, mind	mind, heart
พระราชธิดา	prá râat-chá-tí-daa	[NC - องค์, พระองค์] (royal) duaghter, princess	daughter
พระราชโอรส	prá râat oh-rót	[NC - องค์, พระองค์] (royal) son, prince	
พระวิจิตรจินดา	jin-daa	[Na] (Name of a prince in the Thai story &#34,Princess Soonnoi's Beautiful House&#34,) Pravijitjinda	
พระอินทร์	prá in	[Na] (a Hindu diety) Indra	
พระเอก	prá àyk	[NC - คน] hero, leading actor	leading actor, hero
พายุ	paa-yú	[N] storm	storm, hurricane, gale
ฟื้น	féun	[V] to retrieve, recover, recoup, regain, revive	[to] recover, recoup, retrieve
ภู	poo	[N] soil, ground, place [NC - ลูก] hill, nountain	mountain
มอบ	môp	[N] muzzle [V] to grant, hand out, give	[to] entrust, bestow, delegate
ม่าน	mâan	[NC - ผืน] curtain, (window shade) blind	
มารดา	maan-daa	[N] (formal) mother	
มีน้ำใจ	mee náam jai	[SV] to be kind, generous, thoughtful	[to] be generous, be kind
มีเรือน	mee reuan	[V] (lit. to have a house) to get married	[to] get married
ไม่มีค่า	mâi mee kâa	[SV] to be worthless, valueless, useless	[to] be worthless, be valueless
ยกโทษให้	yók tôht hâi	[V] to forgive someone	[to] forgive, pardon, excuse
ย้อม	yóm	[V] to dye	[to] dye, color, stain
ยาวิเศษ	yaa wí-sàyt	[NC - ชนิด] best medicine	the best medicine
รับใช้	ráp chái	[V] (as a servant) to serve, be in service of	[to] serve
ราชินี	raa-chí-nee	[NC - องค์, พระองค์] queen	
รูปร่างหน้าตา	rôop râang nâa dtaa	[N] countenance, appearance, expression	
ฤทธิ์	rít	[SV] (Sanskrit loan word) to have supernatural power, tremendous ability, mighty strength [N] (formal, of medicine) effect	supernatural power, divine power, effect, result
ฤทธิ์เดช	rít dàyt	[N] power, might, force	
ฤาษี	reu-sĕe	[NC - ตน] (alt. spelling for ฤๅษี) hermit, ascetic, mediating recluse	
ลูกเรือ	lôok reua	[N] (boat or airplane) crew	crew, staff
วัง	wang	[N] palace	palace, royal residence
วิเศษ	wí-sàyt	[SV] to be wonderful, amazing, magic, holy	superb, excellent, splendid
เวลากลางคืน	way-laa glaang keun	[N] night, night time	
เวียง	wiang	[N] walled city, town, city	walled city, city, town
สวมรอย	sŭam roi	[V] to commit identity theft, (falsley) take someone's place, pose as	[to] commit identity theft
สั่งซื้อ	sàng séu	(of a purchase) to order, request	[to] order, request, direct
สัณฐาน	săn-tăan	[N] (formal) outline, shape, form, status, figure, characteristics	figure, shape
สิ้นพระชนม์	sîn prá chon	[VI] (formal) to die, pass away	[to] pass away, die
แสดง	sà-daeng	[V] to perform, act	[to] show, display, indicate, [to] play, perform, act
โสนน้อย	โสน-น้อย	[Na] (lit. little flowering sanor plant. Name of a princess in a well known Thai novel) Soonnoi	
หน้าเสีย	nâa sĭa	[V] (from concern or fear) to turn pale,	[to] turn pale, lose countenance
หลักฐาน	làk tăan	[N] evidence, proof	
หัวเม็ด	hŭa mét	[N] ornamental knob	
โหร	hŏhn	[NC - คน, ท่าน] fortune teller, astrologer	
อภิเษก	à-pí	[V] to have a wedding ceremony	
อาฆาต	aa-kâat	[SV] (formal) to be vengefuil, hateful, unforgiving, vindictive [VI] to feud [VT] to revenge, avenge	[to] feud, spite, look upon with hatred
อาสา	aa-săa	[V] to volunteer	[to] volunteer
ไอ	ai	[N] vapor, steam, mist [N] warmth [V] to cough [Na] (English loan letter name) I [N] (Chinese loan word 'ai') love	vapour, steam, [to] cough, I, the letter I
กระโชก	grà-chôhk	[V] (of wind) blow in gusts [SV] (tone of voice) to be harsh, stern, shouting [Adv] (to speak) harshly, sternly	[to] gust, blow in gusts, blast, [to] shout, bawl, intimidate
กระท่อม	grà-tôm	[NC - หลัง] cottage, cabin, hut, shed, shanty	Mitragyna speciosa, hut, shed, hovel
กลิ้ง	glîng	[N] roller [V] to roll, wallow, roll over, rotate	[to] roll, rotate, trundle
กะรุ่งกะริ่ง	gà-rûng-gà-rîng	[SV] to be shabby, tattered, ragged	[to be] ragged, tattered, shabby
แก	gae	[Pron] (impolite or colloq.) he, him, she, her, they, them, you	
ขนาด	kà-nàat	[NC - ขนาด] size, dimension, extent, measurement [Cl] (for sizes, dimensions)	size, magnitude, dimension
ขะมักเขม้น	kà-mák-kà-mâyn	[SV] to be energetic, enthusiastic, go-go [Adv] energetically, enthusiastically	energetically, actively, enthusiastically, [to be] energetic, positive, enthusiastic
คนจน	kon jon	[NC - คน] (colloq.) the poor	poor, poor people, poor person
คราวนี้	kraao née	[Adv] this time, at present	this occasion, this time, now
ครู่หนึ่ง	krôo nèung	[N] a moment, minute, a short while	a moment, a few moments, a while
คา	kaa	[V] to be stuck in, embedded in, obstruct, be lodged in [N] stock, iron ring, shackle [N] (in Thailand) grass thatch	[to] stick, remain, strand
คุ้น	kún	[SV] to be familiar with, used to, acquainted with	[to] be familiar, intimate, acquaint
เคียง	kiang	[Adv] near, close by [Adv] adjacent to	closely, near, adjacently
แค่นี้	kâe née	[Adv] only, just [Phrase] that's enough, that's all	only, just, solely, just this much, only this much
จักรยาน	jàk-grà-yaan	[NC - คัน] bicycle	bicycle, bike: cycle
จิตใจ	jìt jai	[N] the mind, heart, spirit, mood	mind, mind, heart
ชุน	chun	[V] to darn, mend, repair, embroider	[to] darn, mend, repair
เชิงเขา	cherng kăo	[N] base of a hill, foothill	foot of the hill
ซับซ้อน	sáp són	[SV] to be complex, complicated	[to] complicate, be complex, confuse
ซูบซีด	sôop-sêet	[SV] to be very skinny, pale, lean, emaciated	[to be] very skinny, emaciated
เซียว	sieow	[SV] to be pale, sickly, gaunt	[to be] pale, gaunt, haggard
ด่วน	dùan	[SV] to be urgent, in a hurry, pressing	[to be] urgent, express
เดินเขา	dern	[V] to trek through the nountains	
โดย	doi	[Prep] by, by means of, through [Conj] because, due to	by, with, by means of
ต้นมะกอก	dtôn má-gòk	[NC - ต้น] olive tree	ash tree
แต่เพียง	dtàe piang	[Adv] only, merely	
ถัด	tàt	[SV] to be next to, following, latter [V] to move forward in ones seat	[to be] next, latter
แถบ	tàep	[NC - แถบ] (English loan word) tape, strip [Cl] (for strips of something) [N] area, zone, region	strip, band, stripe, zone, area
ทอด	tôt	[V] to deep fry [V] to cast, throw, drop [N] span, stretch [V] to prostrate oneself	[to be] deep fried, [to] extend, stretch out, cast out, [to] fry
ทำงานต่อ	tam ngaan dtòr	[V] to go on working, continue working	[to] continue working, go on working
ทุ่ง	tûng	[N] field, farm, pasture, meadow [N] feces, excrement, poop, dung [V] to defecate	field, farm, meadow
นั่งลง	nâng long	[V] to sit down	[to] sit, sit down
น้ำปลา	náam bplaa	[N] fish sauce	
นิดหน่อย	nít nòi	[Adv] not much, a little bit, slight	a little bit, just a little, a tiny bit
นี่เอง	nêe ayng	[Pron] just this	
บัตรประชาชน	bàt bprà-chaa chon	[NC - ใบ] ID card, indentification card	ID card, identification card, identity card
บาตร	bàat	[NC - ใบ, ลูก] (used by Buddhist monks) alms bowl	monk's alms-bowl
เบียด	bìat	[V] to crowd in, press through, press into, shove, throng, jostle	[to] crowd in, squeeze in, jostle
ใบ้	bâi	[SV] to be unable to speak or hear, mute, dumb [V] to gesture silently, tip off, signal	dumbly, silently, mutely, [to] signal, hint, gesture silently, [to be] mute, dumb, silent
ประมาณ	bprà-maan	[Adv] about, approximately [V] to guess, to estimate	about, around, approximately, [to] estimate, approximate, reckon
ปะ	bpà	[V] (not used for electronic or mechanical things) to mend, patch, repair [V] to meet unexpectedly, come across, run into	[to] meet, come across, meet unexpectedly, [to] patch, mend
ปานใด	bpaan dai	[Adv] no matter how much, to the extent that, however much	no matter how much, however much
เป็นมิตร	bpen mít	[SV] to be friendly, cordial, congenial	[to] be friendly, be on friendly terms
เป็นระยะ	bpen rá-yá	[Adv] sporadically [Adv] (reduplicated) intermittently, sporadically, every once in a while	
เปลี่ยว	bplìeow	[SV] (of an animal) to be wild, young, untamed [SV] (of a place) to be deserted, vacant, lonely	[to be] desolate, solitary, isolated
ผิด	pìt	[SV] to be wrong, mistaken, incorrect, false	[to be] wrong, incorrect
ฝัน	făn	[V] to dream [N] dream [Cl] (for dreams)	[to] dream, imagine
ฝืดเคือง	fèut keuang	[V] to suffer [SV] to be in distress, suffering	[to] suffer, distress
ใฝ่	fài	[V] to expect, hope for, have an interest in	[to] aim, expect, hope for
พลาสติก	pláat-dtìk	[N] (English loan word) plastic	
เพชร	pét	[NC - เม็ด, ก้อน, กะรัต] diamond	
เพราะหู	prór hŏo	[SV] to be pleasent sounding, melodious, sweet sounding	pleasant sounding, tuneful
ฟุ้งเฟ้อ	fúng fér	[SV] to be lavish, extravagant	[to be] extravagant, lavish, wasteful
มากกว่า	mâak gwàa	[SV] to be greater than, more than	
มิ	mí	[Adv] (formal) no, not	not, no
มีอายุ	mee aa-yú	[V] to age, get old, be old	[to be] old, elderly, aged
เมตร	máyt	[N] (English loan word, unit of length) meter	metre, meter
แม้	máe	[Conj] even though, even if	even, even if, although, even though
เย็นสบาย	yen sà-baai	[SV] to be cool and refreshed	[to] be nice and cool
ใย	yai	[N] fiber, filiment, web, cobweb [N] (formal) bond, relationship, connection, link, attachment [Cl] (for fine filiments, threads, webs)	web, fiber, thread, [to be] concerned about, connected to
รถจักรยาน	rót jàk-grà-yaan	[NC - คัน] bicycle	
ร่อน	rôn	[V] to hover, glide [V] to winnow, sift, seperate into large and small pieces	[to] hover, [to] winnow, sift
ระยะ	rá-yá	[N] a space, period of time, stage	period, stage, distance
รักใคร่	rák krâi	[V] to love, be fond of, like [N] affection, intimacy, love	[to] love, like, be fond of
เร่	rây	to wander around, hawk goods, peddle	[to] wander about, hawk, peddle
เรียงราย	riang raai	[Adv] orderly, well arranged, lined up [SV] to be tidy, placed around, lined up	orderly, well-arranged, in good order
ลงมือทำ	long meu tam	[V] to proceed, start to do	[to] start to do, set about
ลัง	lang	[NC - ลัง] crate, packing box [Cl] (for boxes)	box, case, casket
ลู่	lôo	[NC] trail, track, path [V] (by the wind) blown over, bent over [Cl] (for trails, tracks, paths)	track, trail, path
ลูกคนโต	lôok kon dtoh	[NC - คน] first born child	eldest child, first child
ลูกชาย	lôok chaai	[NC - คน] son	
สดใส	sòt săi	[SV] to be bright, clear, fresh looking	[to be] bright, clear, fresh, [to be] cheerful, happy, delighted
สลับ	sà-làp	[N] degree, step, grade [SV] to be alternating everyother one [V] to alternate, reciprocate	[to] reciprocate, alternate, take turns
สะใภ้	sà-pái	[NC - คน] (female relative by marriage) sister-in-law, duaghter-in-law- mother-in-law	daughter in-law
สักคน	sàk kon	[Pron] just one person, only one person	
สังกะสี	săng-gà-sĕe	[N] (chem, element, atomic number 30.) zinc [NC - ข้อ] (used as roofing material) galvanized iron, corrugated iron	galvanized iron, corrugated iron, zinc
สำลี	săm-lee	[N] tuft of cotton wool [N] cotton, asorbent cotton [Na] (name of a dog in a story) Samlii	cotton, absorbent cotton, cotton wool
สีคราม	sĕe kraam	[N] the color indego, purple blue	indigo
หน้าตามอมแมม	nâa dtaa mom-maem	[SV] (from dirt) to be dirty faced	
หลงใหล	lŏng-lăi	[SV] to be infatuated with, crazy about	fascinatingly, enticingly, alluringly
ให้นม	hâi nom	[V] to breast feed, nurse	[to] breast-feed, nurse, suckle
อดอยาก	òt yàak	[SV] to be starving	[to] starve
อพยพ	òp-pá-yóp	[V] to move, evacuate, migrate [Na] (Christian, Old Testanent book) Exodus	[to] emigrate, move, evacuate
อัธยาศัยดี	อัด-ทะ-ยา-สัย-ดี	[SV] to be hospitable, courteous	
เอ็ง	eng	[Pron] (used between good friends, but can also be impolite or offensive) you	
เอน	ayn	[V] to recline, bend, lean	[to] lean (on)
เอ็นดู	en-doo	[SV] to be loving, kind, merciful [V] to have affection for, love	[to] be loving, be kind, be merciful
กระโชกโฮกฮาก	grà-chôhk hôhk-hâak	[Adv] (idiom, tone of voice, to speak) harshly, gruffly	harshly, dissonantly, loudly
กระด้าง	grà-dâang	[SV] to be hard, strong, tough [SV] to be harsh, rigid, obstinate, crude	[to be] harsh, rough, tough
กว้างขวาง	gwâang kwăang	[SV] to be large, vast, broad [SV] to be popular, well known, famous	[to be] well-known, famous, popular, [to be] broad, vast, large
กาน้ำ	gaa náam	[NC - ใบ, ลูก] kettle	cormorant, water crow, kettle, teakettle, pot
กำกับ	gam-gàp	[V] to direct, control, regulate, supervise	[to] control, regulate, oversee, [to] attach, add, accompany
กิจการ	gìt-jà-gaan	[N] business, activities, trade [Na] (New Testament book) Acts	business, trade, work
กิริยา	gì-rí-yaa	[N] manners, conduct, behavior	manners, behaviour, behavior
ไก่ป่า	gài bpàa	[NC - ตัว] wild fowl, red jungle chicken	jungle fowl, wild fowl, red jungle fowl
เขต	kàyt	[NC - เขต, แห่ง] (of land) limit, boundry, frontier, border, district, region, zone, site [Cl] (for borders, boundries, limits, sites)	area, region, district
เข้าเรียน	kâo rian	[V] to attend class, go to class	[to] attend class, take a lesson, go to class
คบ	kóp	[V] to associate with, make friends with	"[to] go out with, date, be friends with, More Detail, คบ usually implies a romantic association, but it can be used to describe platonic relationships too. If so, it's usually used in conjunction with เป็นเพื่อน (""as friends"") to stop any misunderstandings."
ความคิดเห็น	kwaam kít hĕn	[NC - อัน] idea, opinion	opinion, view, sentiment
ความจำ	kwaam jam	[Na] memory, the ability to remember	memory, remembrance, commemoration
ความประสงค์	kwaam bprà-sŏng	[N] wish, desire	purpose, aim, intention
คอยท่า	koi tâa	[V] to tarry, wait	[to] wait, await, tarry
คุ้มค่าเหนื่อย	kúm kâa nèuay	[SV] to be worthwile	[to] be worth one's work, be worthwhile
เฆี่ยน	kîan	[V] to whip, beat, flog, slash	[to] flog, whip, beat
โฆษณา	kôht-sà-naa	[V] to advertise, announce, publicize, campaign [NC - ชิ้น] advertisement, ad	[to] advertise, publicize, announce, ad, advert, advertisement
จนกว่า	jon gwàa	[Conj] until, as long as, as far as	until, till, as long as, as far as
แจ้ง	jâeng	[V] (formal) to inform, notify, tell [SV] (poetic) to be obvious, clear, distinct	[to] inform, tell, advise, [to be] clear, open, unobscured
ชั่ว	chûa	[SV] to be bad, evil [Prep] during, throughout	[to be] bad, evil, wicked, throughout, during, in every part of
ใช้แล้ว	chái láew	[SV] to be second hand, previously used	used, second-hand, recycled
ซัก	sák	"[V] to wash clothes, launder [V] to question, interrogate, cross-examine [Adv] (colloq.) a moment ago, just [SV] just, about, around (often implying ""as little as ..."")"	just, about, around, [to] question, interrogate, ask, [to] wash, clean, launder
ญี่ปุ่น	yêe-bpùn	[Na] Japan, Japanese	
ฐาน	tăan	[NC - ฐาน] (both concrete and abstract) base, pedestal, ground, station, platform, reason, basis [Cl] (for bases, foundations, platforms)	basis, base, foundation
ฐานะ	tăa-ná	[N] (relative to others) status, situation, condition, position	status, condition, position
ดูท่า	doo tâa	[VAux] to seem, appear	
ดูท่าทาง	doo tâa taang	[V] to seem to be, be likely to	[to] seem to be, be likely to, seem
เดือนร้อน	deuan rón	[N] hot season, summer	
ตกปลา	dtòk bplaa	[V] to fish with a fishing line, go fishing	[to] angle, fish, catch fish
ต้นหว้า	ต้น-ว่า	[NC - ต้น] black plum tree, jambolan plun tree	
ตรงกัน	dtrong gan	[SV] to be the same, coincide, identical	[to be] identical, the same
ตอนค่ำ	dton-kâm	[N] at night, sunset, dusk, evening time	dusk, sunset, evening
ตั้ง	dtâng	[V] to set up, establish, fix, form, assemble, organize [Cl] (for plies, stacks, wads, packs, slabs) [V] to stand on end, stand erect [V] to begin, start, commence [Adv] as much as, many, costly, more than expected [V] to tune, adjust, regulate [V] to lay, (of an object) place, (of pots, pans, etc.) place on a fire	up to, as much as, [to] set, set up, establish
ตั้งหลัก	dtâng làk	[V] to stand firm to build up one's status, establish oneself	[to] establish oneself, build up one's status, [to] stand firm
ติดคอ	dtìt kor	[V] (of something in one's throat) to stick, get stuck	[to] be stick, get stick, stick in one's throat
เตะ	dtè	[VT] to kick	[to] kick, attack with the foot, punt
ถัดไป	tàt bpai	[N] (in a series) next	
ทำตา	tam dtaa	[V] to show one's feelings with their eyes	[to] show one's feeling with o
ทำมาหากิน	tam maa hăa gin	[VI] to earn a living	[to] earn a living, make a living
ที่ดิน	têe din	[N] land, earth, soil	land, earth, ground
ที่แท้	têe táe	[Adv] in fact, acutally	in fact, actually
ทีแรก	tee râek	[Adv] at first, from the beginning	
ธุระ	tú-rá	[NC - เรื่อง, อัน] errands, personal business	business, duty, affair
นั่งเล่น	nâng lâyn	[V] to sit leisurely	[to] sit leisurely
แน่นอน	nâe non	[Adv] surely, definitely, certainly, for sure [SV] to be sure	certainly, surely, definitely
บริจาค	bor-rí-jàak	[V] to donate, sacrifice to help others [N] (one of the ten kingly virtues) self-sacrifice	[to] donate
บางส่วน	baang sùan	[Pron] some part, certain parts	
เบ็ด	bèt	[NC - คัน] fish hook, barbed hook	fishhook, hook, barbed hook
ประหลาดใจ	bprà-làat jai	[SV] to be amazed, astonished, surprised [V] to wonder	[to] be surprised, wonder, be astonished
ปรารถนาดี	bpràat-tà-năa dee	[V] to wish well, have good wishes	[to] wish well, have good wishes
ปรึกษา	bprèuk-săa	[V] to consult with	[to] consult, confer with, take/seek advice
เป็นหลัก	bpen làk	[Adv] mainly, essentially, importantly	[to] be a principle, be a guideline, mainly, essentially, importantly
ผ่อนผัน	pòn păn	[SV] to be indulgent, lenient [V] to delay	[to] reduce, lessen
พรรคพวก	pák pûak	[N] friends, followers, associates, partners	partisan, followers, friends
พลอย	ploi	[NC - เม็ด] gem,, jewel, precious stone	gem, precious stone
พึ่ง	pêung	[V] to depend on (for help), rely on	just now, just, [to] depend on
ฟุตบอล	fút bon	[NC - ลูก] (English loan word - football) soccer	football, soccer
ภัยอันตราย	pai an-dtà-raai	[N] harm, danger, jeopardy	danger, hazard, peril
มรดก	mor-rá-dòk	[NC - กอง, ชิ้น] estate, bequest, inheritance, legacy, heritage	heritage, inheritance, legacy
มรรยาท	man-yâat	[N] etiquette, manners, courtesy	manners, etiquette
มาอยู่	maa	[V] has come to be located at (someplace)	
เมื่อวานซืน	mêua waan-seun	[N] day before yesterday	the day before yesterday
ไม่สุภาพ	mâi	[SV] to be impolite	
ย่าง	yâang	[V] to roast, barbeque, grill [SV] to be roasted, barbequed, grilled [V] to enter [V] to step on, walk, pace	[to] step, walk, step on, [to be] roasted, grilled, burned, [to] roast, barbecue, bake
เย็นวานนี้	yen	[N] yesterday evening	
เยอะ	yúh	[Adv] plenty, much, many [Adv] (reduplicated) very plentifuly, a lot more, very many	much, much more, far more
รับจ้าง	ráp jâang	[V] to work as an employee, work for wages	[to] work for hire, work freelance
รับรอง	ráp rong	[V] to certify, guarantee, vouch for, recommend [V] to welcome, receive as guest	[to] guarantee, certify, [to] welcome, receive, entertain
โรงอาหาร	rohng aa-hăan	[NC - โรง] cafeteria	cafeteria, canteen
ลูกจ้าง	lôok jâang	[NC - คน] employee, staff member	employee, worker, staff member
เลข	lâyk	[N] numbers, numerals, digits	number, numeral, digit
ว่าที่	wâa têe	[N] acting (for, on behalf of)	acting (as a higher rank), acting (for)
ไว้ใจได้	wái jai dâai	[SV] to be reliable, trustworthy, dependable	[to] trust, rely on, count on
สมัคร	sà-màk	[V] to volunteer, make application for, (for a position) apply [Na] (Thai given name) Samak	[to] apply (for)
สมัยนี้	sà-măi née	[Adv] nowadays, present time	the present, present time, present moment
สร้อย	sôi	[NC - เส้น] necklace [N] refrain, chorus [V] to be sad, grieve [N] mane	
สอนหนังสือ	sŏn năng-sĕu	[V] (of an academic subject) to teach	[to] teach, instruct
สังเกต	săng-gàyt	[V] to observe, notice, take note of	[to] observe, notice, note
สู้	sôo	[V] to fight, struggle against, oppose [V] (of a challlenge) meet, respond to, deal with, persist, persevere	[to] fight, vie, oppose
สูตรคูณ	sòot koon	[NC - แม่] multiplacation table	multiplication table
หน่อไม้	nòr mái	[NC - หน่อ] bamboo shoot, (short for หน่อไม้ฝรั่ง ) asparagus	
หรือว่า	rĕu wâa	[Prep] whichever is the case, whether	or, whichever is the case, whether
หลักแหล่ง	làk làeng	[NC - แห่ง] home, residence, dwelling place	residence, domicile, dwelling place
หอบ	hòp	[VI] to pant, gasp for breath [V] to carry in arms, hold in one's arms	[to] carry in arms, hold in arms, [to] pant, gasp
แหล่ง	làeng	[N] place, location, spot, position [N] source, origin, birthplace	source, location, spot
อบรม	òp-rom	[V] to train, instruct, drill, tutor	[to] teach, instruct, train
อาบ	àap	[VI] to bathe, immerse, swim	[to] bathe, immerse
อีกา	ee-gaa	[NC - ตัว] crow	
อึง	eung	[SV] to be loud, noisy	[to be] noisy, clamorous, loud
อุดมสมบูรณ์	ù-dom sŏm-boon	[SV] to be fertile, [plentiful, abundant	[to] abound, be plentiful, be abundant, plentifully, abundantly, amply
แอบ	àep	[V] to hide, conceal, lie low, sneak, be covert	secretly, covertly, [to] hide, conceal, go into hiding
โอ้โฮ	ôh hoh	[Intj] (colloq., expressing amazement, surprise or emphasis) Oh ho!, wow	wow!, oh!
กล่าวถึง	glàao tĕung	[V] to mention, tell about, relate	[to] mention, talk about, speak of
กาย	gaai	[NC - ตัว] human body, physique, body	
กำหนด	gam-nòt	[N] specification, schedule, appointment [V] to specify, decide, set, assign, prescribe, assign	[to] specify, decide, determine, specification, schedule
กุฏี	gù	[NC - หลัง] (alternate spelling for กุฏิ) monk's dwelling	
เกล็ด	glèt	[NC - เกล็ด] (snow) flake, (fish) scale, grain (chaff), husk [Cl] (for scale like objects) [V] (of fish scales, grain husks, etc.) to remove, descale	scale, flake
โกลาหล	goh-laa-hŏn	[N] (poetic) uproar, tumult, confusion, chaos [SV] (peotic) to be turbulent, unsettled	[to be] in disorder, in confusion, in turmoil
ขวบ	kùap	[Cl] (year of age, particularly for children up to the age of 12)	years old, years of age, More Detail, ขวบ is only used to refer to the ages of children approximately 12 years old or younger. For anyone older, ปี is used instead.
ขอบใจ	kòp jai	[V] to thank (someone of lower status such as younger siblings or one's students)	[to] thank you, be thankful (for something)
ขอร้อง	kŏr róng	[V] to beg, implore, &#34,Please don't&#34,	[to] beg, ask, request
เขี้ยว	kîeow	[NC - ซี่] fang, canine tooth	
คด	kót	[V] to curve, bend, hook, crook [V] to ladle out, dish up, dip up [SV] to be crooked, bent, dishonest, curved, not straightforward	[to] curve, bend, crook, [to] ladle, dip up, dish up
คำกลอน	kam glon	[NC - บท] poem	poem, verse, poetry
คิดเห็น	kít hĕn	[V] to comment, criticize, discuss	[to] comment, discuss, criticize
คิดอ่าน	kít àan	[V] (peotic) to think, plan	[to] ponder, think deeply, meditate
คูหา	koo-hăa	[NC - คูหา] stall, stand, booth [Cl] (for booths) [NC - คูหา] arched entrance, space between pillars [NC - คูหา] cave, cavern, grotto	stand, stall, booth, cave, cavern, grotto
เงือก	ngêuak	[NC - ตัว] mermaid	mermaid, merman
เจรจา	jayn-rá-jaa	[V] (formal) to negotiate, talk	[to] negotiate, converse, discuss
เจ้านาย	jâo naai	[NC - คน] boss, chief, employer [N] royalty, member of the extended royal family	boss, head, master
เจ้าเล่ห์	jâo lây	[SV] to be tricky, cunning, sly [NC - คน] cunning person, trickster	
ฉวี	chà-wĕe	[N] complexion, skin color	
ชะโงก	chá-ngôhk	[V] to lean out, poke one's head out, peer out	[to] lean out
ชัง	chang	[V] to hate, detest, dispise	[to] hate, detest, abhor
ชีเปลือย	chee bpleuay	[NC - คน] nude ascetic	
ซุกซน	súk son	[SV] to be mischievous, naughty	naughtily, mischievously, [to] be naughty, be mischievous
ดาบส	daa-bòt	[NC - ตน] (poetic) recluse, hermit, ascetic	
เดรฉาน	เด-ระ-ฉาน	[NC - ตัว] (alternate spelling for เดรัจฉาน) best, brute, animal	
เดียวกัน	dieow gan	[SV] to be identical, same	same, identical
ได้กลิ่น	dâai glìn	[V] to sniff, smell, (of a smell or scent) pick up	[to] smell, scent, catch the smell
ตามหา	dtaam hăa	[V] to look for (someone or something)	[to] look for someone
ตำ	dtam	[V] to beat, pound sth. [V] to puncture, prick, pierce	[to] pound, pestle, [to] sting, stab, prick
ถาวร	tăa-won	[SV] to be permanent, durable, lasting [Adv] permanently	[to be] permanent, lasting, enduring, permanently
เถาวัลย์	tăo wan	[NC - เถา] (creeping plant) vine	vine, creeping plant, climber
ทันใดนั้น	tan dai nán	[Adv] then, at once, immediately, suddenly	instantly, immediately, abruptly
ที่พึ่ง	têe pêung	[SV] (of a person) to be reliable [N] shelter, protection	supporter, protection, sanctuary
ที่รัก	têe rák	[NC - คน] (term of endearment) sweetheart, beloved, darling, honey	darling, honey, dear
ทุกๆ	túk túk	[Det] every	every, each, each one, all
นวล	nuan	[SV] to cream colored, soft colored, light blond, white, ivory colored	cream, light-colored, ivory
นอง	nong	[V] to overflow, flood [SV] to be flooded, overflowing	[to] flood, deluge, inundation
น้องชาย	nóng chaai	[NC - คน] younger brother	
น้องๆ	nóng nóng	[NC - คน] children, brothers and sisters	
นัดดา	nát-daa	[NC - คน] descendants, grandchild, grandson, granddaughter, nephew, neice	descendant, grandson, granddaughter
น้ำใจ	náam jai	[N] (formal) kindness, generosity, hospitality, good will, thoughtfulness	kindness, spirit, heart
น้ำตา	náam dtaa	[NC - หยด, สาย] (of the eye) tear, tears	
นิล	nin	[SV] (poetic) to be black [NC - เม็ด, ก้อน] (dark precious stone) sapphire	
นิลมังกร	nin	[Na] (Magical flying horse found in an epic Thai poem) Ninnanggon	
บ่น	bòn	[V] to complain, nag, grumble	[to] mutter, grumble, murmur
ประจักษ์	bprà-jàk	[SV] (formal) to be obvious, evident, appearent, certain	[to] be evident, be certain, be convinced
ประสา	bprà-săa	[N] (of behavior) conduct, manner, pattern	manner, way, style
ปล่อง	bplòng	[NC - ปล่อง] chimney, smokestack, (mine or volcano) vent [Cl] (for chimneys, smoestacks, vents)	shaft, funnel, vent
ปล้ำ	bplâm	[V] to struggle with, wrestle with, rape, fight, grapple	[to] struggle, fight, grapple
ปากเปียก	bpàak bpìak	[V] to gumble, complain, admonish	[to] grumble, admonish, take a lot of explaining
ปาน	bpaan	[Adv] almost [Conj] as if [NC - แห่ง, ที่] birthmark	birthmark, like, similar, as
เป็นผล	bpen pŏn	[V] to be the resoult of, due to, result	[to] succeed, work, be successful
แปลกประหลาด	bplàek bprà-làat	[SV] wonderful, strange, unusual, odd, peculiar	strange, odd, uncommon
พ้นภัย	pón pai	[V] to get out of danger	[to] out of danger
พร้อมกัน	próm gan	[Adv] at the same time, concurrently, simultaneously [SV] to be simultaneous	at the same time, simultaneously
พระอภัยมณี	prá	[Na] (A king who was the father of Sudsakorn in an epic Thai poem) Pra Apaimanii	
พวกเจ้า	pûak	[Pron] (polite, senior talking to a group of juniors) you	
พัน	pan	[N] (number) thousand [N] (redupliacted) thousands [V] to coil up, bind, tie up	thousand, [to] wind around, bind, coil, warrant officer, officer of rank
พาหนะ	paa-hà-ná	[NC - คัน] (formal) vehicle, carrier, transport	
พูน	poon	[V] to pile up, heap up [SV] to be piled, heaped [Suf] (as in spoonful, skillful) -ful	[to] pile up, heap, accumulate
ฟาด	fâat	[V] (colloq.) to strike, slash, whip, slap	[to] thrash, strike, beat
ภิญโญสโมสร	pin-yoh	[N] (poetic) prosperity	
ภูตผีปิศาจ	pôot pĕe bpì-sàat	[NC - ตัว, ตน] ghost, spirit, demon	
มัก	mák	[Adv] often, frequently	likely to, inclined to
มั่ง	mâng	[SV] to be rich, abundant [Adv] (colloq., for บ้าง) some, any [V] to have much, possess	
มัจฉา	mát-chăa	[Na] (Needs checking! - Name of a mermaid in a Thai epic poem) Natjacha	fish
ม้าน้ำ	máa náam	[NC - ตัว] seahorse	
ม้านิลมังกร	máa	[Na] (Magical flying horse found in an epic Thai poem) Maninnanggon, Onyx Dragon	
มิ่ง	mîng	[N] (poetic) something that is cherished, good luck token	cherished possession
มีเรื่อง	mee rêuang	[V] to get into an argument, quarrel	[to] get into trouble, quarrel with somebody
แม้น	máen	[SV] to be similar to, look like, resemble [Conj] even, thougth, even if	even, though, even if, even though, [to] resemble, look like, be similar to
ไม่เข้าใจ	mâi kâo jai	[Phrase] don't understand	[to] not understand, not know
ไม้เท้า	mái táo	[NC - อัน] cane, walking stick	staff, cane, walking stick
ไม่สู้	mâi sôo	[SV] to be discouraged, not up to doing (something)	[to] give up, give in
ยอดดี	yôt dee	[SV] to be best	
ยอมให้	yom hâi	[V] to permit, allow, let, agree	[to] yield, agree to let, agree to allow
รอน	ron	[V] to break in pieces, cut, sever, cut down, undermine [Na] (English nickname) Ron	[to] cut, sever
รอบคอบ	rôp-kôp	[V] to look around carefully [SV] to be thorough, careful, complete	[to] be cautious, be circumspect, be careful, carefully, circumspectly, cautiously
รักษาตัว	rák-săa dtua	[V] to take care of oneself	[to] be treated, be nursed, [to] take care of oneself
ร่ำเรียน	râm rian	[V] to study hard, learn diligently	[to] study, learn
รู้เรื่อง	róo rêuang	[V] to understand, know	[to] understand, see, know
ลงมือ	long meu	[V] to start (to do something), begin	[to] start, begin
ลิ้น	lín	[N] tongue [N] reed, valve	tongue, reed, value
ลึกล้ำ	léuk lám	[SV] to be forceful, (of meaning) profound, deep	
เล่ม	lâym	[Cl] (for books, and some long things with handles, such as carts, sharp metal objects such as knives and scissorts, oars, plus candles)	เล่ม is the classifier for books, knives and candles
เล่ห์	lây	[NC - อัน] trick, stratagem, artifice	trick, intrigue, cunning
เลี้ยวลด	líeow lót	[SV] to be zig-zag, winding [V] to meander, wind, snake through	[to] meander, wind, snake through, [to be] winding, zigzag, sinuous
วัวควาย	wua kwaai	[NC - ตัว] cattle, livestock	
วิ่งเต้น	wîng dtâyn	[V] to make a great effort	[to] make every effort, make a great effort
วิชาการ	wí-chaa gaan	[N] (formal) technology, technique, (skill) technical	academic, technical, academic matter, technical matter
วิทยา	wít-tá-yaa	[Na] science, knowledge [Na] (common Thai given name) Witya	knowledge, philosophy, science
วุ่นวายใจ	wûn waai jai	[SV] to be tense, serious, strained, nervous	[to] be serious, tense, strain
เวลานัด	way-laa nát	[NC - ครั้ง] appointment	
เวียน	wian	[V] to go around in a circle, rotate, revolve, whirl	[to] circle, revolve, go around
ไว้ใจ	wái jai	[V] to trust, have faith in, rely on	[to] believe in, have faith in, rely
สถาน	sà-tăan	[N] place, location, area, establishment	status, state, situation, place, area, site, item, kind, thing
สวัสดิ์	sà-wàt	[N] happiness	
สำเหนียก	săm-nìak	[V] to pay attention to, listen carefully, contemplate	[to] listen carefully to, pay attention to
สุดสาคร	sùt săa-kon	[Na] (Legendary character who went seeking his father in an epic Thai poem) Sudsakorn	
เสียที	sĭa tee	[SV] to be tricked, defeated, outwitted [V] to lose an advantage, to make a mistake	"It's a particle showing a desire for the action of the statement/question to happen quickly and/or completely, or frustration that it hasn't already happened, It's a particle implying ""just once even once"""
หนัก	nàk	[SV] to be heavy, fully loaded [SV] (of a medical or other problem) to be serious [N] (pertaining to the) anus [SV] to be anal	severely, harshly, [to be] heavy, hard, [to be] serious, severe
หายตัว	hăai dtua	[V] to disappear, vanish from sight	[to] disappear, be invisible, vanish
เหียน	hĭan	[V] to feel sick [SV] to be nauseous [V] to rotate, turn, whirl, revolve	[to] feel nauseous, feel sick, [to] turn, rotate, shift
อด	òt	[V] to fast, abstain from food, give up, starve [SV] to be bearable, endureable	[to] refrain, go without, miss out on
อ้วนท้วน	ûan-túan	[SV] to be fat, chubby, rotund, plump [V] to gain weight, fatten	[to be] plump, corpulent, fat
อวบ	ùap	[SV] to be fat, plump, overweight, chubby	overweight, plump, heavy
อ้าย	âai-kìk	[Pron] (designation used with first names of men, usually in contenpt or with criminals) eldest son, eldest brother [SV] (archaic) to be first, one	
อายุ	aa-yú	[N] age, aged [Prep] to, for	
อาลัย	aa-lai	[V] (poetic) to grieve, feel sad, deplore, miss, feel sorrowful	[to] feel sad, feel sorrowful
ก้ม	gôm	[V] to bend oneself down, bow down	[to] bend down, stoop, bow
ก้มหน้า	gôm nâa	[V] to bend forward, lower one's head	[to] low one's head, bend down the head, [to] persevere, bear, endure
กระดิ่ง	grà-dìng	[NC - ใบ, ลูก] a small bell	bell, small bell
กระพริบ	grà-príp	[V] to wink, blink	blink, flicker
กรุง	grung	[NC - ที่, แห่ง] city, town, capital city	city, capital, metropolis
กรุงรัตนโกสินทร์	grung rát-dtà-ná-goh-sĭn	[Na] (important part of the full name of Bangkok) Grung Rattanakosin	
กวดขัน	gùat kăn	[SV] to be strict, severe	[to] be strict, be stern, be severe
การค้า	gaan káa	[NC] trade, business	business, trade, commerce
การค้าขาย	gaan káa kăai	[N] trade, commerce, business	
การติดต่อ	gaan dtìt dtòr	[N] the activity of contacting someone	contact, communication
การที่	gaan têe	[Prep] in fact, the fact that (something)	the fact that, the reason that
เก้อ	gêr	[SV] to be embarrassed, feel awkeard	in vain, pointlessly, [to be] embarrassed, abashed
ขจัด	kà-jàt	[V] to get rid of, expel, remove, exterminate, wipe out, eliminate	[to] expel, get rid of, wipe out
ขณะ	kà-nà	[Conj] in the meantime, while, meanwhile [Conj] while, when, as [N] instant, moment, short time, (in time) point	
ข้อความ	kôr kwaam	[NC - เรื่อง] statement, message, text message [Cl] (for e-mail messages, text messages)	message, text, statement
ข้าศึก	kâa sèuk	[N] enemy	enemy, foe, adversary
ขุน	kŭn	[V] to feed, nourish, fatten, raise, rear [SV] to be big, large, great, gigantic [Na] (lowest rank in ancient Thai civil heirarchy) regional ruler, leader, head man, chief [NC - ตัว] (chess piece) king	"[to] feed, fatten, fertilize, leader, chief, It's the lowest conferred rank of Thai nobility, below ""Luang"" (หลวง)"
เขียนข้อความ	kĭan	[VI] (on a website) to post	
คณะ	ká-ná	[NC - คณะ] college, group, team, faculity at a university, council [Cl] (for a council, faculty of a university)	faculty, school, branch of study, group, party
คนเรา	kon rao	[Pron] (referring to humans in general) we, us, human, mankind	
คาบ	kâap	[V] to inform, tell [V] to hold in the mouth [N] period, cycle	[to] hold between one's lips, plane, plain, period, time, [to] overlap, extend into
คำว่า	kam wâa	[Phrase] the word ...	
คิดร้าย	kít ráai	[VI] to intend to harm, have malice	[to] have malice, have wicked intentions
คืนหนึ่ง	keun nèung	[Adv] one night	
งบประมาณ	ngóp bprà-maan	[N] budget, estimate	budget, estimate, statement
โง่เง่า	ngôh-ngâo	[SV] to be stupid, foolish, idiotic	[to] be foolish, be stupid, be dull
จับจ่าย	jàp jàai	[V] to buy, spend, use up	[to] buy, expend, spend
จ้าง	jâang	[V] to hire, employ	[to] employ, hire
เจ้าหน้าที่	jâo nâa têe	[NC - คน] government offical, staff person, office worker, policeman	staff, personnel, office worker
โจรผู้ร้าย	john pôo ráai	[NC - คน] thief, criminal, bandit	criminal, thief, robber
ไฉน	chà-năi	[Q] why	
ช่างสังเกต	châang săng-gàyt	[SV] to be observant	[to] be observant
ดำรง	dam-rong	[VI] (formal) to uphold, maintain, sustain, continue [SV] (formal) durable, permanent, lasting	[to] maintain, uphold, sustain
ได้ว่า	dâai	[V] (past tense, perfect tense) has said, said, did say	
ตั้งใจจริง	dtâng jai jing	[V] to determine, intend, mean [Adv] seriously, determinedly	[to] determine, intend, mean, determinedly, seriously
ตัดสินคดี	dtàt sĭn ká-dee	[V] to judge a case	[to] judge a case
ตัวอักษร	dtua àk-sŏn	[N] alphabet, script, font	letter, character, alphabet
ถอนใจ	tŏn jai	[V] to sigh	[to] sigh
ถ้าเช่นนั้น	tâa châyn nán	[Conj] in that case	in case that, in that case
ทบทวน	tóp tuan	[V] (study) to review	[to] reconsider, review
ท้อแท้	tór táe	[SV] to be downhearted, dismayed, dejected, discouraged	[to] tired, weary, down hearted
ทั่วกัน	tûa gan	[Adv] all together, all over, throughly	all together, thoroughly, all over
ทาย	taai	[V] to guess, conjecture, prophesy, foretell [V] (of a problem to answer, solve	[to] guess, conjecture
ทำการบ้าน	tam gaan bâan	[VI] to do homework	[to] do homework
ทำคุณ	tam kun	[V] to oblige, make merit	[to] oblige
ที่สาม	têe săam	[N] (ordinal number) third	
ทุกข์	túk	[N] difficulty, suffering, sadness, sorrow, adversity	[to] suffer
เท่าไร	tâo rai	[Q] how much?, how many? [SV] (in a negative expression) at all	how much, how many, however much
แทรก	sâek	[V] (formal) to insert, mix, add, push in, infiltrate, intervene	[to] insert
ธานี	taa-nee	[NC - แห่ง] city	city, town, borough
นเรศวร	ná-ray-sŭan	[Na] (King of Ayutthaya kingdom who reigned from 1555 to 1605 AD) King Naresuan	king, monarch, master
นักปราชญ์	nák bpràat	[NC - คน] philosopher	philosopher, sage, learned man
นับว่า	náp wâa	[V] to count as, regard as	[to] regard as, count as, reckon as
นาก	nâak	[NC - ตัว] otter [Na] (Thai female given name or nickname meaning 'an alloy of gold, silver and copper') Nak, Naak [N] an alloy of gold and copper, red gold	copper alloy, pinchbeck, otter
แน่ะ	แน่ะ	[Part] (colloq., used to emphasize what has gone before) [Part] (colloq., used to call attention to something)	
บ้า	bâa	[SV] (of a person) to be crazy, mad, insane [SV] (reduplicated) to be very crazy	[to be] mad, crazy, insane
บางระจัน	บาง-ระ-จัน	[Na] (Place in central Thailand) Bang Rachan	
บางอย่าง	baang yàang	[Pron] something, some things	
โบราณ	boh-raan	[SV] to be ancient, old-fashioned, out of date	ancient, outdated, archaic
ปกครอง	bpòk krong	[V] to rule, govern. administer	[to] govern, rule, administer
ประดิษฐ์	bprà-dìt	[VT] to create, invent, devise, discover, evolve, originate [Na] (Thai given name) Pradit	[to] invent, create, make up, [to be] artificial, fake, counterfeit
ประหยัด	bprà-yàt	[V] to economize, save, conserve, preserve [SV] to be inexpensive, cheap, thrifty, economical	[to] economize, save, be thrifty
ปรับปรุง	bpràp bprung	[V] (formal) to improve, make better	[to] adjust, improve, make an adjustment
ปราบปราม	bpràap bpraam	[V] to repress, conquer, subjugate, quell	[to] suppress, repress, bring under control
ปัจจุบัน	bpàt-jù-ban	[Adv] currently, now a day, these days	at present, now, at this time
เป็นครั้งแรก	bpen kráng râek	[Adv] for the first time	
แปลว่า	bplae	[V] to mean that (something)	
พลเมือง	pon-lá-meuang	[N] population, citizen, inhabitant, people	
พาณิชย์	paa-nít	[N] commerce, business, trade	commerce, trade, business
พินาศ	pí-nâat	[N] destruction, ruin, death, perish, annihlation	[to] fall, wreck and ruin
พูดแทรก	pôot sâek	[VI] (of a conversation) to interrupt, break in, butt in	[to] interrupt, break into
ฟุ่มเฟือย	fûm-feuay	[SV] to be extravagant, lavish, wasteful	[to] spend extravagantly, be wasteful
ภาชนะ	paa-chá-ná	[NC - ลูก, ใบ, ชิ้น, อัน] conatianer, utensil, vessel	container, utensil, ware
ภาระ	paa-rá	[N] duty, responsibility, obligation, task	burden, responsibility, charge
มหา	má-hăa	[SV] to be great, many, much, large [N] (title conferred on monks who have passed the third of nine grades in Pali studies)	great, large
มาสู่	maa sòo	[V] to come to, reach, arrive at	[to] come (to), move toward, reach
มีโอกาส	mee oh-gàat	[VAux] to have a chance, have opportunity to, could	[to] have a chance, have an opportunity
เมืองหลวง	meuang lŭang	[NC - แห่ง] capital (of a country or state)	capital city
แม่น	mâen	[SV] to be accurate, precise, correct, exact [Adv] accurately, precisely, exactly	accurately, exactly, precisely
แม่นยำ	mâen yam	[SV] to be exact, accurate, precise [Adv] exactly, accurately, precisely	accurately, exactly, correctly, accurate, exact, correct
ไมตรี	mai-dtree	[N] friendship, goodwill, friendly relations	friendship, friendliness, goodwill
ยาม	yaam	[N] night watchman, guard, [N] time, period [N] (period of time for a night watchman) shift, duty watch	time, hour, period, security guard, guard, sentry
ยืนยง	yeun-yong	[SV] to be permanent [V] (poetic) to endure, persevere, continue, persist	[to] last, endure, maintain
รวดเร็ว	rûat reo	[SV] to be fast, quick, speedy	[to be] fast, rapid, quick
ร้อย	rói	[N] (number) 100 [N] lieutenant [V] to string together, thread	hundred, [to] thread, string together, Lieutenant, Captain
รัชกาล	rát-chá-gaan	[NC - สมัย] (of a king) a reign	
รัชกาลที่	rát-chá-gaan-têe nèung	[N] (followed by a numeral n) King Rama n	
ราช	râat	[SV] to be royal, of the king, regal	king, monarch, royal
ราม	raam	[Na] (Thai male given name derived from the name of Thai kings and means 'thunder giant) Ram	Rama
ร่าเริง	râa rerng	[SV] to be merry, joyful, happy [V] to make merry	[to] be cheerful, be happy, be delighted, cheerfully, delightfully, happily
รุกราน	rúk raan	[V] to invade, trespass, raid, attack	[to] invade, attack, assault
รุ่งเรือง	rûng reuang	[V] to succeed, flourish, prosper, progress	[to] flourish, progress, be prosperous
ลงท้าย	long táai	[V] to end up, finish	finally, at last, [to] end up, end
ล่วงหน้า	lûang nâa	[Adv] in advance, ahead of time, beforehand	beforehand, in advance, ahead
ลำธาร	lam-taan	[NC - สาย] stream, canal, creek, waterway	canal, waterway, watercourse
วันก่อน	wan gòn	[NC - วัน] previous day	the other day
วันหน้า	wan nâa	[N] (colloq.) one day, some day	future, following day, next time
วิธีการ	wí-tee gaan	[N] how to (do something), procedure, method	method, way, procedure
เศรษฐี	sàyt-tĕe	[NC - คน] rich person, wealthy person	millionaire, rich man, wealthy man
สมเด็จพระ	sŏm dèt prá	[N] (royal, title for members of the royal family, and high ranking Buddhist monks) His Majesty, His Honor	His majesty, Her majesty
สมอง	sà-mŏng	[N] brain	brains, head, intelligence
สมัย	sà-măi	[NC] era, times, period, session, age [Cl] (for era, times, periods, sessions, ages)	age, era
สะกด	sà-gòt	[V] (formal) to spell, spell out [V] (formal) to control, restrain, suppress [V] (formal) to cast a spell, put to sleep by magic [V] (formal) to spy on, track, follow [SV] to be supressing	[to] follow, spy on, track, [to] suppress, control, restrain, [to] spell, spell out, [to] hypnotize, mesmerize, put in a trance
สั่น	sàn	[V] to twitch, shake, shudder, tremble	[to] shake, sway, shiver
สุโขทัย	sù-kŏh-tai	[Na] (geo., province in northern Thailnd) Sukhothai	
หงอน	ngŏn	[NC - อัน] (of a bird) crest, comb, topknot, hood	
หน้ามุข	nâa múk	[NC - แห่ง, อัน] porch, veranda	
หมายถึง	măai tĕung	[V] to mean, be defined as	[to] mean
หวัง	wăng	[V] to hope, wish, expect, want	[to] hope, wish
แหง	ngăe	[SV] (colloq.) to be confounded, abashed [SV] (colloq.) to be certain, sure [Adv] (colloq.) certainly, surely	definitely, for sure
แหม	măe	[Intj] (expressing surprise, shyness or discontent)	oh!, More Detail, interjection showing surprise or in response to over/under reaction
องค์	ong	[NC - องค์] part of a body, organ [Cl] (for royalty, priests, images of Buddha, gods, pagodas) [N] (formal) part, portion, share, section, period [N] (formal) character, characteristic, attribute, feature, manner, appearance [N] (formal, of a drama) an act [N] governing body, organization	organ, part of body, More Detail, องค์ is the classifier for members of royalty, monks and Buddha images.
อย่างเช่น	yàang châyn	[Conj] such as, for example, for instance	such as, for example, for instance, so
อย่าเพิ่ง	yàa pêrng (...) ná	[Phrase] don't (do something) yet	
อ๋อ	ŏr	[Intj] (expresses understanding) Oh!, Yes!	oh, yes, well, right
ออกเสียง	òk sĭang	[VI] (formal) to pronounce, speak out loud, vote	[to] pronounce, voice, sound, [to] vote, elect, choose
อักษรไทย	àk-sŏn tai	[N] Thai alphabet	
อ่านว่า	àan	[Phrase] read as ...	
เอกราช	àyk-gà-râat	[SV] (of a country) to be independent [N] independence, autonomy	sovereignty, independence
โอกาส	oh-gàat	[N] chance, opportunity, occasion (for)	opportunity, chance
กติกา	gà-dtì-gaa	[NC - ข้อ] rule, agreement, convent, regulation	rule, regulation, order
กลางแจ้ง	glaang jâeng	[SV] to be outdoors, open-air	in the open air, out of doors, outdoor, open-air, alfresco
กองไฟ	gong fai	[NC - กอง] bonfire	bonfire, campfire
การแข่งขัน	gaan kàeng kăn	[N] competition, contest	
การชุมนุม	gaan chum-num	[NC - ครั้ง] meeting, gathering, rally, congress	congregating
การผจญภัย	gaan pà-jon pai	[NC - ครั้ง] adventure	adventure, risk, venture
กิจกรรม	gìt-jà-gam	[NC - ครั้ง] activity	activity, operation
กิโลเมตร	gì-loh máyt	[N] (English loan word) kilometer	kilometre, kilometer
ไกลๆ	glai glai	[Adv] very far	
ข้อเท้า	kôr táo	[NC - ข้าง] ankle	
ขี้ผึ้ง	kêe pêung	[N] beeswax	beeswax, wax
เข็มทิศ	kĕm tít	[NC - อัน] (magnetic) compass	
แขก	kàek	[NC - คน] guest, visitor [N] (someone of south Asiaian or southwest Asiaian decennt) Indian, Persian	guest, visitor, Indian
แข่งขัน	kàeng kăn	[V] to compete, contend	[to] race, contest, compete
ความตื่นเต้น	kwaam dtèun dtâyn	[N] excitement, enthusiasm	excitement, agitation
คัดเลือก	kát lêuak	[V] to select, pick out, choose	[to] choose, select, pick
คับคั่ง	káp kâng	[SV] to be congested, crowded, jam-packed, jammed	[to] be crowded, be jammed, be congested
ค้างคืน	káang keun	[V] to stay overnight	[to] stay overnight
ค่าย	kâai	[NC - ค่าย] camp, campground [Cl] (for camps, campgrounds)	
เครื่องหมาย	krêuang măai	[NC - อัน] mark, sign, symbol, emblem, badge, token, road sign	mark, symbol, sign
ง่ายๆ	ngâai ngâai	[SV] to be easy, simply	[to] be simple, be easy, be uncomplicated
จัดฉาก	jàt chàak	[V] (to make it appear as if an innocent person did something bad) to frame [V] to arrange scenery, set a scene	[to] arrange the scenery, prepare the scenery
ชั่วคราว	chûa kraao	[SV] (see note) to be temporary [Adv] temporarly	temporarily
ชุมนุม	chum-num	[V] to gather together, congregate	group, collection, party, [to] congregate, assemble, gather
ซิบๆ	síp síp	[Adv] (of blood) dripping, oozing	drizzly
ด้านหลัง	dâan lăng	[N] rear, behind [Prep] in back of	backside, rear, behind
ดาย	daai	[VT] to weed, mow, trim [SV] to be vacant, alone, free, all by oneself [V] to ignore, pay no attention to	[to] weed, mow, only, alone
เดินทางไกล	dern taang glai	[V] to take a trip, travel, journey	[to] take a trip, travel, journey
ต้นสน	dtôn sŏn	[NC - ต้น] pine tree, fir tree	
ตรงนั้น	dtrong nán	[Pron] there, that place	
ตรวจดู	dtrùat doo	[V] to look into, check, inspect, examine	[to] look into, examine, check
ตุ๋น	dtŭn	[V] to stew, braise	[to] swindle, deceive, trick, [to be] steamed, stewed
ตุ่ม	dtùm	[NC - เม็ด, ตุ่ม] lump, node, outgrowth, pimple [NC - ใบ, ลูก] water jar [Cl] (for lumps, nodes, pimples, outgrowths)	pimple, sore, bump, large earthen jar, jar, water jar
เตียน	dtian	[SV] to be cleared, (of land) flat, cleaned	[to be] clear, clean
ทิศใต้	tít dtâi	[N] (compass direction) south	South
ทิศทาง	tít taang	[N] direction, points of a compass	direction, way
ที่หมาย	têe măai	[NC - ที่] target, object, aim, destination, objective	target, aim, objective
นกอินทรี	nók-in-see	[NC - ตัว] eagle	
นกอินทรีย์	nók in-see	[NC - ตัว] (alt. spelling for นกอินทรี) eagle	eagles
นาย	naai	[N] employer, boss, master, ruler [N] Mr., mister [Pron] (2nd person pronoun for male superiors and friends) you [Cl] (for male persons, make officials)	you, mister, Mr., superior, master, boss, More Detail, Classifier for men, usually used when referring to officials of the government, police or armed forces.
นิยม	ní-yom	[SV] to be popular [N] principle, theory, doctrine [V] to order, appoint, decree	[to be] popular, in fashion, [to] admire, appreciate, principle, theory, doctrine
เนิน	nern	[N] mound, knoll [NC - ทาง, ที่] slope, incline [Cl] (for mounds, knolls)	
บ้วน	bûan-bpàak	[V] to spit out, expectorate, gargle	
ประจำตัว	bprà-jam dtua	[SV] to be personal, private, individual	
ปิ้ง	bpîng	[V] to grill, broil, roast, bake, toast	[to] toast, bake
เป็นพิเศษ	bpen pí-sàyt	[Adv] especially, particularly	specially, particularly, extraordinarily
ผ้าพันคอ	pâa pan kor	[NC - ผืน] scarf, muffler	
ผิวหนัง	pĭw năng	[N] (formal) skin	
ผื่น	pèun	[N] (of the skin) rash	prickly heat, heat rash, sudamina
เผ่น	pàyn	[VI] to act quickly, leap, spring, rush	[to] leap, jump
ฝ่าอันตราย	fàa an-dtà-raai	[V] to risk one's life	[to] risk one's life
พลอง	plong	[NC - อัน] staff, boy scout staff	small timber tree, staff, boy scout staff
พักแรม	pák raem	[V] to camp, tarry, stay overnight	[to] stay overnight, spend the night
มีพิษ	mee pít	[SV] to be poisonous, toxic	[to] be poisonous, be toxic
แม่เหล็ก	mâe lèk	[NC - แห่ง, อัน] magnet	
ยกย่อง	yók yông	[V] to praise, exalt, respect	[to] esteem, respect, value
ยาทา	yaa taa	[N] ointment, lotion	vanishing cream, unguent, warpaint
ย่าม	yâam	[NC - ใบ, ลูก] (usually made of wonven fabric) satchel, ktbag, sack	bag, satchel, kitbag
รัด	rát	[SV] to be tight, snug, binding (together) [V] to bind, fasten, tie up, squeeze	[to] bind, fasten, tighten, [to be] tight, tight-fitting
ลาน	laan	[NC - ลาน] courtyard, open space, plaza, lawn [NC - ลาน] (of coiled metal) a spring [SV] to be dazzling, blurred, indistinct [Cl] (for courtyards, plazas, lawns, yards) [NC - ลาน] (general term) fan palm	field, pitch, lawn, spring, coil, [to] be dazzled, be blurred, be indistinct
ลุกฮือ	lúk heu	[V] to rebel, revolt, rise up, mutiny	[to] rise up, rebel, revolt
ลูกเสือ	lôok sĕua	[NC - ตัว] tiger cub [NC - คน] (lit. 'tiger cub') boy scout	
เล็กๆ น้อยๆ	lék lék nói nói	[N] (focus on size or amount) a tine bit, very little bit	small, little, tiny
เลือด	lêuat	[N] blood	
ศึก	sèuk	[NC - ครั้ง] battle, fight, conflict, war, combat	war, campaign, fight
สติ	sà-dtì	[N] sense, mind, consciouness, thought	consciousness, sense, mind
ส่วนตัว	sùan dtua	[SV] to be personal, private	[to be] individual, personal, private
ส่อง	sòng	[V] (of a telescope, microscope, or binoculars) to look through, look at [V] to shine on, illuminate	[to] look through, [to] shine, illuminate, shed
สะกดรอย	sà-gòt roi	[V] (formal) to follow a trail, slueth, spy on, track	[to] shadow, tail, follow the track of
สะพาย	sà-paai	[V] (over the shoulder) to carry, sling	[to] carry on the shoulder
สาธารณสุข	săa-taa-rá-ná sùk	[N] public health	
สามัญ	săa-man	[SV] regular, ordinary, common, plain [N] (of Thai tone) middle, ordinary	[to be] common, ordinary, normal
สาเหตุ	săa-hàyt	[NC - อัน] cause, reason	cause, reason, determinant
สำนักงาน	săm-nák ngaan	[N] place of work, office	office, bureau
สำรอง	săm-rong	[V] to reserve, keep, hold back [NC - คน] understudy, extra, bench player, reserves	[to] reserve, keep back, store up, [to be] reserved
สุดฝีมือ	sùt fĕe meu	[Adv] do one's best, best of one's abilities	beyond one's capability, do one's best
เสียสละ	sĭa sà-là	[V] to sacrifice	[to] sacrifice, make a sacrifice
ใส่ยา	sài yaa	[V] to apply medication	[to] apply medication, apply a remedy
ให้คะแนน	hâi ká-naen	[V] to (give a) grade, mark, score	[to] give a score, give a mark
อาการ	aa-gaan	[N] (medical) symptom, condition [N] organ, part of the body [Cl] (for medical symptoms)	expression, manner, action, symptom, indication, condition